Player,Season,Position,Age,Team,GP,GS,MP,FG,FGA,FG%,3P,3PA,3P%,2P,2PA,2P%,EFG,FT,FTA,FT%,ORB,DRB,TRB,AST,STL,BLK,TO,PF,PTS
Victor Alexander,2002,C,32,DET,1,0,3,0,1,.000,0,0,,0,1,.000,.000,0,0,,0,1,1,0,0,0,0,0,0
Derek Anderson,2002,SG,27,POR,3,0,76,13,30,.433,2,6,.333,11,24,.458,.467,16,18,.889,3,4,7,7,2,0,6,1,44
Kenny Anderson,2002,PG,31,BOS,16,16,560,82,197,.416,0,0,,82,197,.416,.416,28,35,.800,13,37,50,76,21,0,28,58,192
Darrell Armstrong,2002,PG,33,ORL,4,4,158,20,42,.476,4,17,.235,16,25,.640,.524,17,21,.810,3,8,11,13,5,0,7,14,61
Chucky Atkins,2002,PG,27,DET,10,10,294,43,118,.364,14,39,.359,29,79,.367,.424,13,17,.765,5,19,24,34,6,1,14,25,113
Stacey Augmon,2002,SG,33,CHH,9,0,152,16,41,.390,0,0,,16,41,.390,.390,16,21,.762,7,20,27,13,10,1,12,21,48
Vin Baker,2002,C,30,SEA,5,4,144,29,58,.500,1,1,1.000,28,57,.491,.509,7,9,.778,11,14,25,4,3,6,4,23,66
Dana Barros,2002,PG,34,DET,4,0,6,1,3,.333,0,1,.000,1,2,.500,.333,0,0,,0,0,0,1,0,0,0,2,2
Brent Barry,2002,SG,30,SEA,5,5,149,14,34,.412,7,16,.438,7,18,.389,.515,4,4,1.000,6,17,23,14,3,4,9,12,39
Jon Barry,2002,SG,32,DET,10,0,177,29,61,.475,17,38,.447,12,23,.522,.615,5,8,.625,4,16,20,21,5,1,19,14,80
Tony Battie,2002,C,25,BOS,16,16,443,42,86,.488,0,0,,42,86,.488,.488,13,21,.619,39,82,121,13,10,30,11,51,97
Raja Bell,2002,SG,25,PHI,3,0,8,1,3,.333,0,2,.000,1,1,1.000,.333,0,0,,1,0,1,0,0,0,0,0,2
Jonathan Bender,2002,SF,21,IND,5,0,45,3,6,.500,0,1,.000,3,5,.600,.500,0,0,,0,4,4,2,2,3,5,6,6
Mike Bibby,2002,PG,23,SAC,16,16,661,114,257,.444,25,59,.424,89,198,.449,.492,71,86,.826,14,46,60,80,23,3,37,30,324
Chauncey Billups,2002,PG,25,MIN,3,3,134,23,51,.451,6,15,.400,17,36,.472,.510,14,20,.700,1,14,15,17,3,1,9,14,66
Corie Blount,2002,PF,33,PHI,5,0,88,2,8,.250,0,0,,2,8,.250,.250,3,4,.750,10,4,14,2,2,2,4,9,7
Mark Blount,2002,C,26,BOS,4,0,39,2,4,.500,0,0,,2,4,.500,.500,2,2,1.000,3,4,7,1,2,2,1,7,6
Bruce Bowen,2002,SF,30,SAS,10,10,345,25,61,.410,11,25,.440,14,36,.389,.500,7,14,.500,9,24,33,14,11,7,7,28,68
Michael Bradley,2002,PF,22,TOR,1,0,3,0,0,,0,0,,0,0,,,0,0,,0,1,1,1,0,0,0,1,0
Shawn Bradley,2002,C,29,DAL,7,0,25,3,6,.500,0,0,,3,6,.500,.500,0,0,,1,4,5,0,0,1,1,9,6
Jamison Brewer,2002,SG,21,IND,2,0,6,0,2,.000,0,0,,0,2,.000,.000,1,2,.500,2,2,4,1,0,0,1,3,1
Chucky Brown,2002,SF,33,SAC,1,0,1,0,0,,0,0,,0,0,,,0,0,,0,1,1,0,0,0,0,1,0
Kedrick Brown,2002,SF,20,BOS,2,0,3,2,2,1.000,1,1,1.000,1,1,1.000,1.250,0,0,,0,0,0,0,0,1,0,0,5
P.J. Brown,2002,C,32,CHH,9,9,331,32,75,.427,0,0,,32,75,.427,.427,28,37,.757,29,57,86,14,6,12,8,37,92
Rick Brunson,2002,PG,29,POR,2,0,2,0,0,,0,0,,0,0,,,0,0,,0,0,0,0,0,0,0,0,0
Kobe Bryant*,2002,SG,23,LAL,19,19,833,187,431,.434,22,58,.379,165,373,.442,.459,110,145,.759,28,83,111,87,27,17,54,65,506
Mark Bryant,2002,PF,36,SAS,9,4,91,9,20,.450,0,0,,9,20,.450,.450,3,6,.500,8,4,12,1,1,2,1,14,21
Greg Buckner,2002,SG,25,DAL,7,0,105,12,25,.480,0,1,.000,12,24,.500,.480,3,4,.750,13,13,26,4,3,1,3,15,27
Jud Buechler,2002,SF,33,ORL,2,0,10,0,0,,0,0,,0,0,,,0,0,,0,1,1,1,1,0,0,0,0
Elden Campbell,2002,PF,33,CHH,9,9,254,49,110,.445,0,1,.000,49,109,.450,.445,24,34,.706,14,46,60,16,6,23,17,34,122
Chris Childs,2002,PG,34,TOR,5,4,163,21,54,.389,8,17,.471,13,37,.351,.463,9,10,.900,2,17,19,37,4,0,20,15,59
Doug Christie,2002,SG,31,SAC,16,16,644,54,132,.409,17,64,.266,37,68,.544,.473,52,65,.800,19,73,92,79,33,9,44,64,177
Keon Clark,2002,C,26,TOR,5,5,174,26,48,.542,0,0,,26,48,.542,.542,15,16,.938,14,26,40,8,2,8,14,19,67
Speedy Claxton,2002,PG,23,PHI,5,0,49,4,12,.333,0,1,.000,4,11,.364,.333,4,6,.667,1,0,1,14,5,0,3,8,12
Derrick Coleman,2002,PF,34,PHI,5,5,191,22,42,.524,4,13,.308,18,29,.621,.571,16,20,.800,15,31,46,10,1,7,5,10,64
Jarron Collins,2002,C,23,UTA,4,4,47,10,18,.556,0,0,,10,18,.556,.556,2,2,1.000,4,3,7,0,0,0,4,11,22
Jason Collins,2002,C,23,NJN,17,0,227,12,33,.364,0,0,,12,33,.364,.364,25,38,.658,24,17,41,7,5,6,12,48,49
Austin Croshere,2002,PF,26,IND,4,0,59,8,20,.400,2,6,.333,6,14,.429,.450,6,8,.750,4,10,14,2,1,1,6,7,24
Vonteego Cummings,2002,PG,25,PHI,1,0,1,0,0,,0,0,,0,0,,,0,0,,0,0,0,0,0,0,0,0,0
Dell Curry,2002,SG,37,TOR,4,0,59,10,25,.400,4,5,.800,6,20,.300,.480,4,4,1.000,0,5,5,4,5,2,3,4,28
Michael Curry,2002,SG,33,DET,10,10,221,22,39,.564,5,13,.385,17,26,.654,.628,8,11,.727,1,13,14,12,4,0,5,32,57
Antonio Daniels,2002,SG,26,SAS,10,0,224,35,77,.455,6,16,.375,29,61,.475,.494,19,22,.864,3,24,27,15,7,3,5,13,95
Antonio Davis,2002,PF,33,TOR,5,5,202,34,75,.453,0,0,,34,75,.453,.453,17,28,.607,16,37,53,7,2,5,10,17,85
Baron Davis,2002,PG,22,CHH,9,9,401,71,188,.378,21,62,.339,50,126,.397,.434,40,67,.597,16,47,63,71,32,5,27,36,203
Dale Davis,2002,C,32,POR,3,3,70,3,11,.273,0,0,,3,11,.273,.273,1,2,.500,6,14,20,4,4,3,2,16,7
Andrew DeClercq,2002,C,28,ORL,2,0,9,0,0,,0,0,,0,0,,,0,2,.000,0,0,0,0,0,0,1,3,0
Tony Delk,2002,SG,28,BOS,14,0,227,23,65,.354,13,33,.394,10,32,.313,.454,7,12,.583,8,26,34,16,8,5,15,13,66
Vlade Divac*,2002,C,33,SAC,16,16,535,70,151,.464,2,7,.286,68,144,.472,.470,74,98,.755,46,103,149,27,18,20,37,76,216
Bryce Drew,2002,PG,27,CHH,2,0,5,1,1,1.000,0,0,,1,1,1.000,1.000,0,0,,0,0,0,2,0,0,0,0,2
Predrag Drobnjak,2002,C,26,SEA,3,1,38,4,12,.333,0,0,,4,12,.333,.333,2,4,.500,3,5,8,2,1,0,1,2,10
Chris Dudley,2002,C,36,POR,2,0,3,0,1,.000,0,0,,0,1,.000,.000,0,0,,0,2,2,0,0,0,1,1,0
Tim Duncan*,2002,PF,25,SAS,9,9,380,82,181,.453,1,3,.333,81,178,.455,.456,83,101,.822,28,102,130,45,6,39,37,22,248
Evan Eschmeyer,2002,C,26,DAL,3,0,8,0,1,.000,0,0,,0,1,.000,.000,0,0,,1,1,2,1,0,1,0,2,0
Patrick Ewing*,2002,C,39,ORL,4,0,67,8,25,.320,0,1,.000,8,24,.333,.320,10,17,.588,5,17,22,4,1,4,2,12,26
Danny Ferry,2002,SF,35,SAS,10,0,155,10,33,.303,7,20,.350,3,13,.231,.409,1,4,.250,5,15,20,8,0,1,2,19,28
Michael Finley,2002,SF,28,DAL,8,8,373,69,148,.466,14,37,.378,55,111,.495,.514,45,50,.900,13,37,50,18,12,4,15,24,197
Derek Fisher,2002,PG,27,LAL,19,19,649,60,168,.357,29,81,.358,31,87,.356,.443,44,56,.786,10,52,62,52,19,1,20,49,193
Jeff Foster,2002,C,25,IND,5,0,78,7,13,.538,2,4,.500,5,9,.556,.615,4,9,.444,5,19,24,7,3,1,9,13,20
Rick Fox,2002,SF,32,LAL,19,19,652,67,139,.482,15,43,.349,52,96,.542,.536,37,49,.755,24,78,102,64,21,6,45,70,186
Lawrence Funderburke,2002,PF,31,SAC,5,0,20,2,3,.667,0,0,,2,3,.667,.667,2,2,1.000,1,1,2,0,0,0,0,5,6
Kevin Garnett*,2002,PF,25,MIN,3,3,130,24,56,.429,1,2,.500,23,54,.426,.438,23,32,.719,16,40,56,15,5,5,12,11,72
Pat Garrity,2002,PF,25,ORL,4,4,147,12,32,.375,7,18,.389,5,14,.357,.484,3,4,.750,4,26,30,9,2,1,3,18,34
Devean George,2002,SF,24,LAL,19,0,327,38,104,.365,8,35,.229,30,69,.435,.404,11,15,.733,24,44,68,11,11,10,12,51,95
Horace Grant,2002,C,36,ORL,4,4,127,8,22,.364,0,0,,8,22,.364,.364,2,2,1.000,8,23,31,9,3,1,2,7,18
Adrian Griffin,2002,SG,27,DAL,4,1,57,10,17,.588,0,2,.000,10,15,.667,.588,0,2,.000,2,7,9,4,2,1,3,6,20
Matt Harpring,2002,SF,25,PHI,5,5,119,22,44,.500,0,0,,22,44,.500,.500,7,9,.778,13,13,26,7,5,0,5,12,51
Lucious Harris,2002,SG,31,NJN,20,0,418,65,133,.489,8,22,.364,57,111,.514,.519,39,47,.830,13,41,54,18,13,0,16,29,177
Kirk Haston,2002,PF,22,CHH,2,0,4,1,1,1.000,0,0,,1,1,1.000,1.000,0,0,,0,1,1,0,1,0,0,1,2
Robert Horry,2002,PF,31,LAL,19,14,703,61,136,.449,24,62,.387,37,74,.500,.537,30,38,.789,36,118,154,61,33,16,30,66,176
Troy Hudson,2002,PG,25,ORL,4,0,106,18,48,.375,0,5,.000,18,43,.419,.375,15,16,.938,0,4,4,6,0,0,8,4,51
Lindsey Hunter,2002,PG,31,LAL,18,0,132,14,45,.311,8,29,.276,6,16,.375,.400,0,0,,2,5,7,10,2,0,5,19,36
Allen Iverson*,2002,SG,26,PHI,5,5,209,45,118,.381,9,27,.333,36,91,.396,.419,51,63,.810,1,17,18,21,13,0,12,8,150
Bobby Jackson,2002,PG,28,SAC,16,1,374,65,146,.445,11,43,.256,54,103,.524,.483,34,43,.791,15,37,52,32,14,3,18,31,175
Jaren Jackson,2002,SG,34,ORL,3,0,5,0,0,,0,0,,0,0,,,0,0,,0,1,1,0,0,0,1,3,0
Jermaine Jackson,2002,SG,25,TOR,4,0,12,2,3,.667,0,0,,2,3,.667,.667,2,6,.333,0,1,1,0,0,0,3,2,6
Marc Jackson,2002,C,27,MIN,1,0,1,0,0,,0,0,,0,0,,,0,0,,0,0,0,0,0,0,0,1,0
Jerome James,2002,C,26,SEA,5,1,70,9,23,.391,0,0,,9,23,.391,.391,0,2,.000,4,8,12,4,0,5,4,18,18
Richard Jefferson,2002,SF,21,NJN,20,0,441,53,114,.465,0,2,.000,53,112,.473,.465,33,60,.550,16,76,92,25,11,9,26,40,139
Anthony Johnson,2002,SG,27,NJN,19,0,161,20,53,.377,1,10,.100,19,43,.442,.387,9,11,.818,2,12,14,21,6,0,8,24,50
Alvin Jones,2002,C,23,PHI,2,0,5,0,0,,0,0,,0,0,,,0,0,,0,1,1,0,0,0,1,0,0
Damon Jones,2002,PG,25,DET,10,0,181,16,42,.381,8,27,.296,8,15,.533,.476,3,4,.750,1,20,21,25,5,0,6,14,43
Shawn Kemp,2002,PF,32,POR,3,0,35,2,7,.286,0,0,,2,7,.286,.286,7,10,.700,2,6,8,0,1,0,2,8,11
Steve Kerr,2002,PG,36,POR,3,0,39,6,14,.429,2,8,.250,4,6,.667,.500,5,5,1.000,0,4,4,5,1,0,1,6,19
Jason Kidd*,2002,PG,28,NJN,20,20,803,147,354,.415,17,90,.189,130,264,.492,.439,80,99,.808,42,122,164,182,34,8,67,40,391
Andrei Kirilenko,2002,SF,20,UTA,4,4,122,11,28,.393,0,4,.000,11,24,.458,.393,13,16,.813,4,11,15,4,7,10,6,10,35
Kerry Kittles,2002,SG,27,NJN,20,20,580,94,216,.435,18,68,.265,76,148,.514,.477,35,45,.778,19,44,63,45,32,9,17,37,241
Raef LaFrentz,2002,C,25,DAL,8,8,245,39,78,.500,6,18,.333,33,60,.550,.538,6,11,.545,18,43,61,5,2,22,6,39,90
Rusty LaRue,2002,PG,28,UTA,4,0,53,6,16,.375,2,5,.400,4,11,.364,.438,6,10,.600,0,6,6,6,1,0,4,6,20
Quincy Lewis,2002,SG,24,UTA,4,0,56,8,23,.348,1,5,.200,7,18,.389,.370,0,4,.000,1,2,3,2,2,1,3,10,17
Rashard Lewis,2002,SF,22,SEA,3,2,79,12,32,.375,1,6,.167,11,26,.423,.391,13,13,1.000,4,7,11,2,1,0,2,10,38
Randy Livingston,2002,PG,26,SEA,5,0,80,7,17,.412,1,3,.333,6,14,.429,.441,5,5,1.000,1,5,6,10,2,0,1,7,20
Felipe LÃ³pez,2002,SG,27,MIN,3,0,30,1,4,.250,1,2,.500,0,2,.000,.375,1,2,.500,1,0,1,1,1,0,1,6,4
George Lynch,2002,SF,31,CHH,9,7,286,29,59,.492,2,6,.333,27,53,.509,.508,9,13,.692,32,44,76,14,10,6,10,26,69
Todd MacCulloch,2002,C,26,NJN,20,20,384,52,106,.491,0,0,,52,106,.491,.491,19,31,.613,44,60,104,14,5,27,23,51,123
Mark Madsen,2002,PF,26,LAL,7,0,10,0,1,.000,0,1,.000,0,0,,.000,0,0,,0,2,2,0,0,0,1,1,0
Jamaal Magloire,2002,C,23,CHH,8,0,168,22,40,.550,0,0,,22,40,.550,.550,54,71,.761,17,28,45,5,0,15,17,30,98
Karl Malone*,2002,PF,38,UTA,4,4,163,30,73,.411,0,1,.000,30,72,.417,.411,20,28,.714,3,27,30,18,5,3,11,11,80
Donny Marshall,2002,SF,29,NJN,7,0,14,1,5,.200,0,4,.000,1,1,1.000,.200,1,1,1.000,0,0,0,0,0,0,0,1,3
Donyell Marshall,2002,SF,28,UTA,4,0,124,21,50,.420,3,6,.500,18,44,.409,.450,12,16,.750,14,17,31,11,3,6,5,5,57
Kenyon Martin,2002,PF,24,NJN,20,20,749,129,304,.424,2,9,.222,127,295,.431,.428,76,110,.691,30,86,116,57,24,25,52,86,336
Jamal Mashburn,2002,SF,29,CHH,1,1,10,0,6,.000,0,1,.000,0,5,.000,.000,0,0,,0,1,1,1,0,0,0,0,0
Desmond Mason,2002,SF,24,SEA,5,5,205,24,57,.421,1,3,.333,23,54,.426,.430,10,17,.588,5,26,31,9,4,2,5,11,59
Walter McCarty,2002,PF,27,BOS,14,0,194,17,38,.447,3,18,.167,14,20,.700,.487,7,9,.778,8,26,34,4,4,0,4,19,44
Tracy McGrady*,2002,SG,22,ORL,4,4,178,42,91,.462,5,16,.313,37,75,.493,.489,34,46,.739,6,19,25,22,2,7,13,11,123
Derrick McKey,2002,SF,35,PHI,4,0,40,4,8,.500,0,0,,4,8,.500,.500,0,0,,3,3,6,1,1,2,1,5,8
Aaron McKie,2002,SG,29,PHI,5,0,146,20,46,.435,6,16,.375,14,30,.467,.500,7,10,.700,2,16,18,12,10,0,10,12,53
Stanislav Medvedenko,2002,C,22,LAL,7,0,21,3,5,.600,0,0,,3,5,.600,.600,0,0,,1,3,4,0,0,0,1,8,6
Ron Mercer,2002,SG,25,IND,5,0,117,18,36,.500,0,0,,18,36,.500,.500,3,4,.750,0,10,10,4,1,1,3,9,39
Brad Miller,2002,C,25,IND,5,5,180,20,44,.455,0,0,,20,44,.455,.455,16,20,.800,17,32,49,7,4,2,7,16,56
Mike Miller,2002,SF,21,ORL,4,1,72,7,21,.333,1,8,.125,6,13,.462,.357,4,4,1.000,0,5,5,5,4,0,4,8,19
Reggie Miller*,2002,SG,36,IND,5,5,198,42,83,.506,13,31,.419,29,52,.558,.584,21,24,.875,0,16,16,14,8,1,14,10,118
Sam Mitchell,2002,SF,38,MIN,3,2,34,3,9,.333,0,0,,3,9,.333,.333,2,2,1.000,0,2,2,3,1,1,0,5,8
Dikembe Mutombo*,2002,C,35,PHI,5,5,173,14,31,.452,0,0,,14,31,.452,.452,16,26,.615,14,39,53,3,2,9,11,16,44
Lee Nailon,2002,SF,26,CHH,9,1,160,27,59,.458,0,1,.000,27,58,.466,.458,15,19,.789,10,14,24,6,3,0,7,17,69
Eduardo NÃ¡jera,2002,PF,25,DAL,8,4,122,16,23,.696,0,0,,16,23,.696,.696,5,8,.625,3,10,13,1,3,0,2,22,37
Steve Nash*,2002,PG,27,DAL,8,8,323,51,118,.432,20,45,.444,31,73,.425,.517,34,35,.971,7,25,32,70,4,0,30,20,156
Rasho NesteroviÄ,2002,C,25,MIN,3,3,92,15,31,.484,0,0,,15,31,.484,.484,4,9,.444,6,14,20,3,1,0,4,10,34
Johnny Newman,2002,SF,38,DAL,3,2,22,1,7,.143,1,6,.167,0,1,.000,.214,0,0,,0,0,0,2,0,0,0,5,3
Dirk Nowitzki,2002,C,23,DAL,8,8,357,73,164,.445,16,28,.571,57,136,.419,.494,65,74,.878,17,88,105,18,16,6,22,27,227
Jermaine O'Neal,2002,PF,23,IND,5,5,192,34,76,.447,0,1,.000,34,75,.453,.447,18,24,.750,6,32,38,5,4,8,14,24,86
Shaquille O'Neal*,2002,C,29,LAL,19,19,776,203,384,.529,0,0,,203,384,.529,.529,135,208,.649,67,172,239,54,10,48,62,62,541
Hakeem Olajuwon*,2002,C,39,TOR,5,0,86,12,22,.545,0,0,,12,22,.545,.545,4,6,.667,9,10,19,2,7,4,6,9,28
Kevin Ollie,2002,PG,29,IND,5,0,118,11,26,.423,1,2,.500,10,24,.417,.442,6,6,1.000,0,12,12,23,3,0,5,6,29
Greg Ostertag,2002,C,28,UTA,4,0,87,13,21,.619,0,0,,13,21,.619,.619,1,10,.100,19,15,34,2,2,6,6,14,27
Olumide Oyedeji,2002,C,20,SEA,3,0,17,4,5,.800,0,0,,4,5,.800,.800,1,5,.200,4,2,6,1,0,0,1,2,9
Robert Pack,2002,PG,32,MIN,3,0,10,1,5,.200,0,1,.000,1,4,.250,.200,1,1,1.000,0,0,0,0,0,0,1,5,3
Scott Padgett,2002,PF,25,UTA,4,0,47,6,13,.462,0,3,.000,6,10,.600,.462,4,5,.800,7,7,14,2,1,1,5,6,16
Tony Parker,2002,PG,19,SAS,10,10,341,62,136,.456,10,27,.370,52,109,.477,.493,21,28,.750,5,24,29,40,9,1,22,22,155
Cherokee Parks,2002,C,29,SAS,5,0,43,4,14,.286,0,0,,4,14,.286,.286,0,1,.000,3,8,11,0,0,2,2,6,8
Ruben Patterson,2002,SF,26,POR,3,0,65,5,15,.333,0,1,.000,5,14,.357,.333,6,8,.750,2,5,7,1,3,1,3,7,16
Gary Payton*,2002,PG,33,SEA,5,5,207,45,106,.425,4,15,.267,41,91,.451,.443,17,29,.586,10,33,43,29,3,2,13,12,111
Anthony Peeler,2002,SG,32,MIN,3,0,67,9,20,.450,5,9,.556,4,11,.364,.575,4,6,.667,1,12,13,2,4,0,6,5,27
Morris Peterson,2002,SF,24,TOR,5,5,154,18,49,.367,2,17,.118,16,32,.500,.388,8,10,.800,3,11,14,11,5,3,7,17,46
Paul Pierce*,2002,SG,24,BOS,16,16,672,122,303,.403,30,104,.288,92,199,.462,.452,120,157,.764,27,110,137,66,27,20,61,52,394
Scottie Pippen*,2002,SF,36,POR,3,3,99,18,39,.462,6,11,.545,12,28,.429,.538,7,8,.875,8,20,28,17,4,2,10,14,49
Scot Pollard,2002,C,26,SAC,15,0,193,21,40,.525,0,0,,21,40,.525,.525,8,12,.667,29,24,53,3,7,5,3,36,50
Terry Porter,2002,PG,38,SAS,10,0,131,13,35,.371,5,17,.294,8,18,.444,.443,2,4,.500,1,8,9,8,4,0,5,10,33
Vladimir RadmanoviÄ,2002,PF,21,SEA,5,2,113,14,32,.438,7,13,.538,7,19,.368,.547,3,3,1.000,6,12,18,5,1,1,5,11,38
Zach Randolph,2002,PF,20,POR,1,0,1,0,0,,0,0,,0,0,,,0,0,,0,0,0,0,0,0,0,0,0
Å½eljko RebraÄa,2002,C,29,DET,5,0,69,5,11,.455,0,0,,5,11,.455,.455,11,14,.786,4,6,10,0,1,1,4,14,21
Don Reid,2002,PF,28,ORL,4,0,38,4,6,.667,0,0,,4,6,.667,.667,1,2,.500,3,3,6,0,1,2,0,15,9
Mitch Richmond*,2002,SG,36,LAL,2,0,4,1,1,1.000,0,0,,1,1,1.000,1.000,1,2,.500,0,1,1,0,0,0,1,0,3
Clifford Robinson,2002,PF,35,DET,10,10,409,45,124,.363,18,53,.340,27,71,.380,.435,24,30,.800,5,25,30,29,18,19,21,28,132
David Robinson*,2002,C,36,SAS,4,4,81,9,19,.474,0,0,,9,19,.474,.474,0,4,.000,6,17,23,5,3,3,2,14,18
Rodney Rogers,2002,SF,30,BOS,16,0,394,46,108,.426,19,52,.365,27,56,.482,.514,31,35,.886,28,60,88,34,16,7,22,42,142
Malik Rose,2002,PF,27,SAS,10,3,292,46,96,.479,0,1,.000,46,95,.484,.479,37,50,.740,27,52,79,14,10,5,12,31,129
Bryon Russell,2002,SG,31,UTA,4,4,120,9,36,.250,6,15,.400,3,21,.143,.333,4,4,1.000,6,11,17,7,4,0,9,15,28
Brian Scalabrine,2002,PF,23,NJN,6,0,14,1,3,.333,0,1,.000,1,2,.500,.333,0,0,,1,2,3,0,0,1,1,0,2
Ansu Sesay,2002,SF,25,SEA,4,0,60,3,8,.375,0,0,,3,8,.375,.375,1,1,1.000,2,12,14,4,0,4,2,8,7
Brian Shaw,2002,PG,35,LAL,19,0,238,21,63,.333,9,32,.281,12,31,.387,.405,4,4,1.000,9,26,35,30,5,6,8,16,55
Charles Smith,2002,SG,26,SAS,4,0,19,2,3,.667,0,0,,2,3,.667,.667,1,2,.500,2,1,3,2,2,1,3,5,5
Joe Smith,2002,C,26,MIN,3,1,43,3,7,.429,0,0,,3,7,.429,.429,7,8,.875,4,7,11,0,0,1,1,8,13
Steve Smith,2002,SG,32,SAS,10,10,298,32,87,.368,10,38,.263,22,49,.449,.425,29,30,.967,14,20,34,17,8,1,7,20,103
Eric Snow,2002,PG,28,PHI,5,5,171,18,56,.321,1,6,.167,17,50,.340,.330,17,22,.773,3,19,22,27,6,0,15,13,54
Jerry Stackhouse,2002,SF,27,DET,10,10,361,53,165,.321,18,53,.340,35,112,.313,.376,52,63,.825,9,34,43,43,6,6,27,26,176
Michael Stewart,2002,C,26,TOR,1,0,8,2,2,1.000,0,0,,2,2,1.000,1.000,0,0,,0,3,3,0,0,1,1,2,4
John Stockton*,2002,PG,39,UTA,4,4,141,18,40,.450,2,7,.286,16,33,.485,.475,12,13,.923,3,13,16,40,11,1,8,16,50
Peja StojakoviÄ,2002,SF,24,SAC,10,7,338,50,133,.376,13,48,.271,37,85,.435,.425,35,39,.897,16,47,63,10,5,0,19,22,148
Damon Stoudamire,2002,PG,28,POR,3,3,99,5,22,.227,3,4,.750,2,18,.111,.295,2,3,.667,1,6,7,10,2,0,4,5,15
Erick Strickland,2002,PG,28,BOS,12,0,118,11,39,.282,4,20,.200,7,19,.368,.333,9,9,1.000,2,11,13,17,5,1,9,15,35
Bruno Å undov,2002,C,21,IND,1,0,2,1,1,1.000,0,0,,1,1,1.000,1.000,0,0,,0,0,0,0,0,0,0,0,2
Wally Szczerbiak,2002,SF,24,MIN,3,3,131,21,44,.477,2,9,.222,19,35,.543,.500,16,18,.889,9,12,21,6,2,0,8,8,60
Jamaal Tinsley,2002,PG,23,IND,5,5,88,8,19,.421,0,1,.000,8,18,.444,.421,2,3,.667,2,8,10,25,2,0,12,12,18
Robert Traylor,2002,PF,24,CHH,8,0,62,7,20,.350,0,1,.000,7,19,.368,.350,4,6,.667,4,12,16,3,2,2,4,15,18
Gary Trent,2002,PF,27,MIN,3,0,48,8,16,.500,0,0,,8,16,.500,.500,3,6,.500,5,4,9,1,0,0,3,8,19
Hedo TÃ¼rkoÄlu,2002,SF,22,SAC,16,8,443,55,137,.401,12,34,.353,43,103,.417,.445,16,31,.516,17,66,83,23,6,9,23,49,138
Nick Van Exel,2002,SG,30,DAL,8,1,264,37,101,.366,7,34,.206,30,67,.448,.401,8,12,.667,7,17,24,31,8,0,12,26,89
Keith Van Horn,2002,SF,26,NJN,20,20,643,97,241,.402,37,84,.440,60,157,.382,.479,35,49,.714,32,101,133,41,19,9,35,56,266
Antoine Walker,2002,PF,25,BOS,16,16,703,131,319,.411,42,109,.385,89,210,.424,.476,50,64,.781,23,115,138,52,24,6,55,56,354
Samaki Walker,2002,PF,25,LAL,19,5,240,24,52,.462,1,1,1.000,23,51,.451,.471,13,17,.765,32,46,78,4,2,6,12,42,62
Ben Wallace*,2002,C,27,DET,10,10,408,28,59,.475,0,0,,28,59,.475,.475,17,39,.436,48,113,161,12,19,26,19,24,73
Gerald Wallace,2002,SF,19,SAC,5,0,14,0,1,.000,0,0,,0,1,.000,.000,4,4,1.000,1,0,1,1,0,1,2,3,4
Rasheed Wallace,2002,PF,27,POR,3,3,125,28,69,.406,7,17,.412,21,52,.404,.457,13,16,.813,10,27,37,5,2,2,2,12,76
Chris Webber*,2002,PF,28,SAC,16,16,667,160,319,.502,0,4,.000,160,315,.508,.502,59,99,.596,49,124,173,75,14,25,46,64,379
Bonzi Wells,2002,SG,25,POR,3,3,106,14,38,.368,0,7,.000,14,31,.452,.368,9,13,.692,4,8,12,13,6,1,11,11,37
David Wesley,2002,SG,31,CHH,9,9,377,52,129,.403,17,38,.447,35,91,.385,.469,21,23,.913,3,14,17,31,10,2,21,30,142
Rodney White,2002,SF,21,DET,1,0,2,0,1,.000,0,0,,0,1,.000,.000,0,0,,0,0,0,0,0,0,1,0,0
Aaron Williams,2002,PF,30,NJN,20,0,416,46,96,.479,0,1,.000,46,95,.484,.479,38,46,.826,24,46,70,16,8,16,23,78,130
Alvin Williams,2002,PG,27,TOR,5,5,196,24,75,.320,3,14,.214,21,61,.344,.340,9,11,.818,2,22,24,28,6,2,8,12,60
Eric Williams,2002,SF,29,BOS,16,16,487,47,94,.500,14,30,.467,33,64,.516,.574,17,23,.739,18,52,70,21,25,4,11,53,125
Jerome Williams,2002,PF,28,TOR,5,1,143,14,33,.424,0,0,,14,33,.424,.424,8,12,.667,16,17,33,7,9,1,4,19,36
Monty Williams,2002,SF,30,ORL,4,3,93,14,27,.519,0,1,.000,14,26,.538,.519,6,10,.600,7,15,22,9,3,0,5,8,34
Shammond Williams,2002,SG,26,SEA,3,0,38,6,14,.429,2,4,.500,4,10,.400,.500,2,3,.667,1,3,4,3,2,0,4,1,16
Corliss Williamson,2002,SF,28,DET,10,0,269,52,112,.464,0,2,.000,52,110,.473,.464,29,38,.763,19,34,53,10,9,2,22,31,133
Metta World Peace,2002,SF,22,IND,5,5,167,22,54,.407,6,13,.462,16,41,.390,.463,9,13,.692,6,24,30,16,13,3,9,19,59
Wang Zhizhi,2002,C,24,DAL,8,0,44,7,16,.438,3,6,.500,4,10,.400,.531,3,6,.500,5,3,8,3,0,1,0,11,20
Tariq Abdul-Wahad,2003,SG,28,DAL,8,0,79,9,30,.300,0,2,.000,9,28,.321,.300,7,8,.875,11,11,22,7,0,0,1,6,25
Courtney Alexander,2003,PG,25,NOH,5,0,39,7,16,.438,1,1,1.000,6,15,.400,.469,3,4,.750,2,2,4,1,2,0,1,6,18
John Amaechi,2003,C,32,UTA,2,0,16,1,4,.250,0,0,,1,4,.250,.250,2,4,.500,0,1,1,0,0,0,0,4,4
Derek Anderson,2003,PG,28,POR,2,2,22,1,4,.250,0,1,.000,1,3,.333,.250,0,1,.000,1,0,1,0,0,0,1,1,2
Kenny Anderson,2003,PG,32,NOH,5,0,51,4,12,.333,0,0,,4,12,.333,.333,3,3,1.000,0,2,2,9,3,0,4,6,11
Darrell Armstrong,2003,PG,34,ORL,7,1,226,20,44,.455,6,18,.333,14,26,.538,.523,20,22,.909,7,10,17,26,6,0,17,22,66
Carlos Arroyo,2003,PG,23,UTA,3,0,27,3,9,.333,0,0,,3,9,.333,.333,3,4,.750,2,0,2,5,0,0,0,2,9
Chucky Atkins,2003,PG,28,DET,17,3,312,32,91,.352,18,49,.367,14,42,.333,.451,21,26,.808,2,18,20,26,17,0,18,39,103
Stacey Augmon,2003,SG,34,NOH,4,0,69,5,15,.333,0,0,,5,15,.333,.333,7,8,.875,1,9,10,3,3,0,3,8,17
Jon Barry,2003,SG,33,DET,14,0,172,23,54,.426,15,33,.455,8,21,.381,.565,9,9,1.000,5,19,24,20,8,1,7,14,70
Tony Battie,2003,C,26,BOS,10,10,213,31,55,.564,0,3,.000,31,52,.596,.564,4,8,.500,13,36,49,5,4,14,7,42,66
Raja Bell,2003,SG,26,DAL,17,7,305,40,73,.548,6,13,.462,34,60,.567,.589,11,20,.550,13,38,51,27,5,0,6,41,97
Jonathan Bender,2003,SF,22,IND,3,0,34,5,15,.333,3,9,.333,2,6,.333,.433,4,6,.667,3,4,7,0,0,2,0,2,17
Mike Bibby,2003,PG,24,SAC,12,12,404,57,135,.422,11,39,.282,46,96,.479,.463,27,34,.794,8,23,31,60,14,5,18,31,152
Chauncey Billups,2003,PG,26,DET,14,14,485,71,190,.374,26,84,.310,45,106,.425,.442,84,90,.933,4,43,47,66,9,2,34,38,252
Mark Blount,2003,C,27,BOS,10,0,144,12,22,.545,0,0,,12,22,.545,.545,7,10,.700,12,24,36,2,11,8,8,20,31
Bruce Bowen,2003,SF,31,SAS,24,24,750,54,145,.372,35,80,.438,19,65,.292,.493,23,42,.548,14,55,69,39,20,17,15,52,166
Shawn Bradley,2003,C,30,DAL,17,7,246,20,50,.400,0,1,.000,20,49,.408,.400,9,12,.750,23,42,65,5,3,14,15,48,49
J.R. Bremer,2003,PG,22,BOS,10,0,147,16,56,.286,8,32,.250,8,24,.333,.357,7,8,.875,0,15,15,12,3,0,8,12,47
Kedrick Brown,2003,SF,21,BOS,3,0,11,1,4,.250,0,0,,1,4,.250,.250,1,2,.500,2,0,2,0,1,0,0,0,3
P.J. Brown,2003,PF,33,NOH,6,6,193,21,44,.477,0,0,,21,44,.477,.477,19,25,.760,20,26,46,6,7,3,5,22,61
Kobe Bryant*,2003,SG,24,LAL,12,12,531,137,317,.432,25,62,.403,112,255,.439,.472,86,104,.827,16,45,61,62,14,1,42,35,385
Mark Bryant,2003,PF,37,BOS,1,0,2,0,0,,0,0,,0,0,,,0,0,,0,0,0,0,0,0,0,0,0
Greg Buckner,2003,SG,26,PHI,10,0,112,10,31,.323,2,9,.222,8,22,.364,.355,4,4,1.000,3,14,17,3,1,2,3,18,26
Pat Burke,2003,C,29,ORL,6,0,43,6,10,.600,0,0,,6,10,.600,.600,5,6,.833,1,10,11,1,1,0,4,9,17
Sam Cassell,2003,PG,33,MIL,6,6,217,39,83,.470,11,21,.524,28,62,.452,.536,14,15,.933,3,16,19,16,3,1,17,20,103
Calbert Cheaney,2003,SG,31,UTA,5,5,122,10,27,.370,0,0,,10,27,.370,.370,2,4,.500,3,4,7,8,2,1,7,15,22
Doug Christie,2003,SG,32,SAC,12,12,381,37,99,.374,6,24,.250,31,75,.413,.404,29,31,.935,15,59,74,55,12,3,22,22,109
Keon Clark,2003,C,27,SAC,12,0,171,20,41,.488,0,0,,20,41,.488,.488,15,21,.714,14,30,44,4,3,8,13,30,55
Speedy Claxton,2003,PG,24,SAS,24,0,326,46,105,.438,0,0,,46,105,.438,.438,33,44,.750,7,38,45,45,16,5,24,38,125
Derrick Coleman,2003,C,35,PHI,12,12,449,59,118,.500,4,10,.400,55,108,.509,.517,41,47,.872,29,67,96,24,7,16,17,36,163
Bimbo Coles,2003,PG,34,BOS,3,0,9,0,4,.000,0,2,.000,0,2,.000,.000,0,0,,0,1,1,2,0,0,0,1,0
Jason Collins,2003,C,24,NJN,20,20,529,33,91,.363,0,2,.000,33,89,.371,.363,51,61,.836,51,74,125,17,13,12,18,74,117
Austin Croshere,2003,PF,27,IND,4,0,46,5,19,.263,0,6,.000,5,13,.385,.263,6,7,.857,8,9,17,3,0,1,3,5,16
Michael Curry,2003,SF,34,DET,15,14,274,16,44,.364,3,9,.333,13,35,.371,.398,6,7,.857,3,13,16,17,7,2,5,35,41
Antonio Daniels,2003,SG,27,POR,6,1,98,9,19,.474,3,5,.600,6,14,.429,.553,1,2,.500,3,5,8,12,1,1,2,5,22
Baron Davis,2003,PG,23,NOH,5,5,194,37,83,.446,12,35,.343,25,48,.521,.518,16,22,.727,4,14,18,42,7,2,15,20,102
Dale Davis,2003,C,33,POR,6,6,162,14,24,.583,0,0,,14,24,.583,.583,17,26,.654,20,28,48,9,5,2,10,11,45
Andrew DeClercq,2003,C,29,ORL,7,6,104,12,20,.600,0,0,,12,20,.600,.600,4,5,.800,8,15,23,2,2,5,9,25,28
Tony Delk,2003,PG,29,BOS,10,10,368,54,114,.474,22,49,.449,32,65,.492,.570,28,32,.875,5,42,47,36,12,4,13,24,158
Vlade Divac*,2003,C,34,SAC,12,12,317,51,91,.560,0,0,,51,91,.560,.560,35,52,.673,30,39,69,27,8,11,16,38,137
Tim Duncan*,2003,PF,26,SAS,24,24,1021,218,412,.529,0,7,.000,218,405,.538,.529,157,232,.677,96,273,369,127,15,79,76,78,593
Evan Eschmeyer,2003,C,27,DAL,5,0,32,3,6,.500,0,0,,3,6,.500,.500,0,0,,2,3,5,2,3,1,0,8,6
Danny Ferry,2003,SF,36,SAS,16,1,101,8,28,.286,4,14,.286,4,14,.286,.357,0,0,,3,20,23,7,2,0,5,20,20
Michael Finley,2003,SF,29,DAL,20,20,822,131,301,.435,47,114,.412,84,187,.449,.513,57,66,.864,25,90,115,60,26,12,31,46,366
Derek Fisher,2003,PG,28,LAL,12,12,424,53,102,.520,29,47,.617,24,55,.436,.662,18,22,.818,5,31,36,22,18,1,18,39,153
Jeff Foster,2003,C,26,IND,6,0,38,6,11,.545,0,0,,6,11,.545,.545,2,2,1.000,4,4,8,2,0,3,0,3,14
Rick Fox,2003,SF,33,LAL,4,4,79,8,18,.444,5,10,.500,3,8,.375,.583,3,4,.750,2,4,6,7,1,1,4,15,24
Lawrence Funderburke,2003,PF,32,SAC,6,0,15,3,8,.375,0,0,,3,8,.375,.375,3,4,.750,3,5,8,0,0,0,1,2,9
Kevin Garnett*,2003,PF,26,MIN,6,6,265,71,138,.514,3,9,.333,68,129,.527,.525,17,28,.607,11,83,94,31,10,10,18,23,162
Pat Garrity,2003,PF,26,ORL,7,1,163,10,35,.286,4,17,.235,6,18,.333,.343,4,4,1.000,4,14,18,5,2,3,5,24,28
Devean George,2003,SF,25,LAL,11,7,318,35,78,.449,10,30,.333,25,48,.521,.513,8,9,.889,11,38,49,24,11,4,12,29,88
Kendall Gill,2003,SG,34,MIN,6,0,118,10,27,.370,2,4,.500,8,23,.348,.407,9,14,.643,6,7,13,7,4,1,4,12,31
Manu GinÃ³bili*,2003,SG,25,SAS,24,0,660,71,184,.386,28,73,.384,43,111,.387,.462,56,74,.757,29,63,92,70,41,9,36,62,226
Gordan GiriÄek,2003,SF,25,ORL,7,7,223,26,56,.464,5,15,.333,21,41,.512,.509,9,11,.818,4,18,22,7,2,1,13,27,66
Drew Gooden,2003,PF,21,ORL,7,7,234,36,90,.400,0,3,.000,36,87,.414,.400,26,36,.722,28,61,89,4,3,6,12,23,98
Adrian Griffin,2003,SG,28,DAL,15,2,131,17,41,.415,1,3,.333,16,38,.421,.427,2,2,1.000,17,27,44,8,4,0,9,24,37
Tom Gugliotta,2003,PF,33,PHO,2,0,10,2,4,.500,0,0,,2,4,.500,.500,1,2,.500,0,2,2,0,0,0,0,2,5
Marcus Haislip,2003,PF,22,MIL,2,1,24,4,6,.667,0,0,,4,6,.667,.667,2,4,.500,2,2,4,2,2,1,1,5,10
Richard Hamilton,2003,SG,24,DET,17,17,659,134,303,.442,9,27,.333,125,276,.453,.457,106,117,.906,18,48,66,45,13,1,57,51,383
Anfernee Hardaway,2003,SG,31,PHO,6,6,244,27,70,.386,9,25,.360,18,45,.400,.450,13,18,.722,9,27,36,26,13,5,13,26,76
Tim Hardaway*,2003,PG,36,IND,4,0,47,5,15,.333,3,10,.300,2,5,.400,.433,0,0,,0,2,2,9,1,0,3,2,13
Matt Harpring,2003,SF,26,UTA,5,5,156,30,62,.484,1,7,.143,29,55,.527,.492,13,16,.813,9,18,27,5,5,1,8,23,74
Al Harrington,2003,SF,22,IND,6,0,103,7,33,.212,0,4,.000,7,29,.241,.212,4,6,.667,7,15,22,5,6,3,10,21,18
Lucious Harris,2003,SG,32,NJN,20,0,435,54,138,.391,11,33,.333,43,105,.410,.431,36,46,.783,19,33,52,32,9,0,22,39,155
Tyrone Hill,2003,PF,34,PHI,10,0,141,12,19,.632,0,0,,12,19,.632,.632,4,4,1.000,12,16,28,2,1,1,6,29,28
Robert Horry,2003,PF,32,LAL,12,10,373,30,94,.319,2,38,.053,28,56,.500,.330,5,9,.556,23,57,80,37,15,12,17,37,67
Troy Hudson,2003,PG,26,MIN,6,6,221,44,106,.415,17,39,.436,27,67,.403,.495,36,38,.947,1,11,12,33,8,0,16,5,141
Steven Hunter,2003,C,21,ORL,7,0,40,3,10,.300,0,0,,3,10,.300,.300,0,3,.000,1,2,3,1,0,3,1,10,6
Allen Iverson*,2003,SG,27,PHI,12,12,557,137,329,.416,19,55,.345,118,274,.431,.445,87,118,.737,11,41,52,89,29,1,47,25,380
Bobby Jackson,2003,PG,29,SAC,12,0,331,63,138,.457,15,43,.349,48,95,.505,.511,31,35,.886,11,43,54,40,12,1,17,22,172
Jim Jackson,2003,SF,32,SAC,12,0,296,49,98,.500,13,28,.464,36,70,.514,.566,24,31,.774,16,31,47,14,8,3,17,34,135
Marc Jackson,2003,C,28,MIN,6,0,110,17,32,.531,0,1,.000,17,31,.548,.531,16,19,.842,10,23,33,8,2,1,9,19,50
Mark Jackson,2003,PG,37,UTA,5,0,83,15,30,.500,5,9,.556,10,21,.476,.583,1,1,1.000,2,3,5,16,3,0,4,11,36
Stephen Jackson,2003,SG,24,SAS,24,24,811,108,261,.414,38,113,.336,70,148,.473,.487,53,66,.803,19,79,98,65,33,9,68,53,307
Casey Jacobsen,2003,SF,21,PHO,6,0,39,2,10,.200,2,5,.400,0,5,.000,.300,0,2,.000,1,2,3,2,3,0,1,4,6
Richard Jefferson,2003,SF,22,NJN,20,20,711,110,231,.476,0,3,.000,110,228,.482,.476,61,85,.718,29,98,127,47,16,4,46,67,281
Anthony Johnson,2003,PG,28,NJN,17,0,122,17,31,.548,3,6,.500,14,25,.560,.597,5,6,.833,3,9,12,19,2,0,8,15,42
Ervin Johnson,2003,C,35,MIL,6,3,76,3,8,.375,0,0,,3,8,.375,.375,0,0,,6,18,24,3,3,5,3,20,6
Joe Johnson,2003,SG,21,PHO,6,0,164,14,51,.275,2,13,.154,12,38,.316,.294,2,5,.400,6,20,26,8,4,2,12,15,32
Shawn Kemp,2003,C,33,ORL,7,0,72,8,21,.381,0,0,,8,21,.381,.381,5,6,.833,1,14,15,0,0,0,4,13,21
Steve Kerr,2003,PG,37,SAS,10,0,46,7,11,.636,5,6,.833,2,5,.400,.864,3,4,.750,1,2,3,6,1,0,1,6,22
Jason Kidd*,2003,PG,29,NJN,20,20,852,137,341,.402,34,104,.327,103,237,.435,.452,94,114,.825,36,118,154,163,36,4,79,46,402
Andrei Kirilenko,2003,SF,21,UTA,5,0,145,18,43,.419,1,7,.143,17,36,.472,.430,21,24,.875,8,16,24,7,3,10,6,6,58
Kerry Kittles,2003,SG,28,NJN,20,20,613,79,200,.395,26,63,.413,53,137,.387,.460,32,42,.762,19,51,70,40,29,5,17,39,216
Toni KukoÄ*,2003,PF,34,MIL,6,0,184,32,65,.492,11,29,.379,21,36,.583,.577,14,20,.700,6,19,25,22,13,1,11,12,89
Raef LaFrentz,2003,C,26,DAL,20,16,491,68,157,.433,8,40,.200,60,117,.513,.459,16,19,.842,36,52,88,5,11,43,14,86,160
Grant Long,2003,PF,36,BOS,8,0,34,1,4,.250,0,0,,1,4,.250,.250,0,0,,3,2,5,1,0,0,1,1,2
George Lynch,2003,SG,32,NOH,6,3,163,18,42,.429,5,18,.278,13,24,.542,.488,1,4,.250,10,27,37,10,6,5,8,14,42
Mark Madsen,2003,PF,27,LAL,12,2,169,13,31,.419,0,1,.000,13,30,.433,.419,7,16,.438,14,14,28,12,3,2,8,32,33
Jamaal Magloire,2003,C,24,NOH,6,6,188,22,49,.449,0,0,,22,49,.449,.449,25,33,.758,17,33,50,2,4,6,9,15,69
Karl Malone*,2003,PF,39,UTA,5,5,191,34,84,.405,0,1,.000,34,83,.410,.405,30,41,.732,7,27,34,20,8,2,20,15,98
Danny Manning,2003,PF,36,DET,4,0,14,1,3,.333,0,1,.000,1,2,.500,.333,0,0,,1,2,3,0,0,1,0,4,2
Stephon Marbury,2003,PG,25,PHO,6,6,272,51,136,.375,5,22,.227,46,114,.404,.393,25,33,.758,6,18,24,34,7,0,23,26,132
Shawn Marion,2003,SF,24,PHO,6,6,282,40,107,.374,9,28,.321,31,79,.392,.416,22,26,.846,21,49,70,12,11,11,13,17,111
Kenyon Martin,2003,PF,25,NJN,20,20,777,149,329,.453,1,11,.091,148,318,.465,.454,79,114,.693,50,137,187,57,29,31,58,92,378
Jamal Mashburn,2003,SF,30,NOH,4,4,162,34,79,.430,6,15,.400,28,64,.438,.468,25,35,.714,0,14,14,21,4,1,10,4,99
Anthony Mason,2003,C,36,MIL,6,0,157,7,17,.412,0,0,,7,17,.412,.412,9,13,.692,4,16,20,1,3,1,8,17,23
Desmond Mason,2003,SF,25,MIL,6,6,204,28,55,.509,0,4,.000,28,51,.549,.509,22,31,.710,6,36,42,5,6,4,7,19,78
Tony Massenburg,2003,C,35,UTA,5,0,70,10,21,.476,0,0,,10,21,.476,.476,5,9,.556,7,14,21,2,0,4,5,9,25
Walter McCarty,2003,SF,28,BOS,10,8,352,36,75,.480,21,52,.404,15,23,.652,.620,6,7,.857,10,33,43,22,8,5,11,35,99
Tracy McGrady*,2003,SG,23,ORL,7,7,308,74,165,.448,16,47,.340,58,118,.492,.497,58,75,.773,10,37,47,33,14,6,26,16,222
Jeff McInnis,2003,PG,28,POR,7,0,99,9,26,.346,0,3,.000,9,23,.391,.346,3,4,.750,5,7,12,19,2,1,6,11,21
Aaron McKie,2003,SF,30,PHI,12,0,315,38,71,.535,5,9,.556,33,62,.532,.570,12,14,.857,5,38,43,22,10,2,15,31,93
Stanislav Medvedenko,2003,PF,23,LAL,9,0,73,15,27,.556,0,0,,15,27,.556,.556,4,6,.667,4,14,18,1,1,1,3,14,34
Ron Mercer,2003,SG,26,IND,6,0,135,16,49,.327,0,0,,16,49,.327,.327,7,8,.875,2,11,13,7,6,1,5,11,39
Brad Miller,2003,C,26,IND,6,6,135,18,40,.450,0,0,,18,40,.450,.450,16,22,.727,10,23,33,15,5,0,9,17,52
Reggie Miller*,2003,SG,37,IND,6,6,176,15,53,.283,4,25,.160,11,28,.393,.321,21,23,.913,1,13,14,14,1,1,7,9,55
JÃ©rÃ´me MoÃ¯so,2003,C,24,NOH,4,0,60,10,16,.625,0,0,,10,16,.625,.625,3,4,.750,8,8,16,5,0,7,4,9,23
Dikembe Mutombo*,2003,C,36,NJN,10,0,115,7,15,.467,0,0,,7,15,.467,.467,4,4,1.000,8,19,27,6,3,9,8,21,18
Eduardo NÃ¡jera,2003,SF,26,DAL,19,5,394,39,86,.453,0,0,,39,86,.453,.453,38,48,.792,36,38,74,15,14,4,16,53,116
Steve Nash*,2003,PG,28,DAL,20,20,729,115,257,.447,37,76,.487,78,181,.431,.519,55,63,.873,15,55,70,145,17,1,51,47,322
Rasho NesteroviÄ,2003,C,26,MIN,6,6,169,19,38,.500,0,0,,19,38,.500,.500,4,6,.667,9,21,30,4,1,4,5,28,42
Dirk Nowitzki,2003,PF,24,DAL,17,17,722,150,313,.479,27,61,.443,123,252,.488,.522,103,113,.912,15,181,196,37,21,16,40,52,430
Jermaine O'Neal,2003,PF,24,IND,6,6,272,43,92,.467,0,3,.000,43,89,.483,.467,51,65,.785,24,81,105,4,3,18,18,22,137
Shaquille O'Neal*,2003,C,30,LAL,12,12,481,121,226,.535,0,0,,121,226,.535,.535,82,132,.621,63,115,178,44,7,34,35,34,324
Mehmet Okur,2003,PF,23,DET,17,0,323,35,80,.438,7,13,.538,28,67,.418,.481,17,32,.531,24,46,70,13,12,12,14,39,94
Greg Ostertag,2003,C,29,UTA,5,5,151,16,36,.444,0,0,,16,36,.444,.444,14,19,.737,19,24,43,8,3,9,8,17,46
Bo Outlaw,2003,C,31,PHO,6,0,70,1,10,.100,0,0,,1,10,.100,.100,2,4,.500,6,7,13,5,1,1,6,19,4
Robert Pack,2003,PG,33,NOH,4,0,42,6,13,.462,0,0,,6,13,.462,.462,3,3,1.000,0,1,1,4,0,0,1,9,15
Scott Padgett,2003,PF,26,UTA,4,0,53,8,19,.421,2,7,.286,6,12,.500,.474,1,2,.500,6,3,9,4,3,0,5,6,19
Jannero Pargo,2003,PG,23,LAL,11,0,129,8,24,.333,4,15,.267,4,9,.444,.417,3,4,.750,3,6,9,14,8,1,7,22,23
Tony Parker,2003,PG,20,SAS,24,24,814,135,335,.403,15,56,.268,120,279,.430,.425,67,94,.713,8,58,66,85,22,3,47,51,352
Ruben Patterson,2003,SF,27,POR,7,0,155,25,52,.481,0,4,.000,25,48,.521,.481,20,29,.690,14,12,26,11,4,1,10,10,70
Gary Payton*,2003,PG,34,MIL,6,6,251,48,112,.429,1,15,.067,47,97,.485,.433,14,20,.700,4,14,18,52,8,1,13,18,111
Anthony Peeler,2003,SG,33,MIN,6,5,166,13,38,.342,2,16,.125,11,22,.500,.368,1,2,.500,5,16,21,18,4,1,4,14,29
Paul Pierce*,2003,SG,25,BOS,10,10,445,77,193,.399,16,45,.356,61,148,.412,.440,101,117,.863,11,79,90,67,21,8,44,38,271
Scottie Pippen*,2003,SF,37,POR,4,1,75,9,22,.409,3,9,.333,6,13,.462,.477,2,2,1.000,2,9,11,13,0,0,7,8,23
Scot Pollard,2003,C,27,SAC,8,0,91,7,24,.292,0,0,,7,24,.292,.292,10,13,.769,17,13,30,2,1,7,7,15,24
Tayshaun Prince,2003,SF,22,DET,15,3,382,49,115,.426,14,48,.292,35,67,.522,.487,29,38,.763,11,46,57,23,8,13,16,20,141
Joel Przybilla,2003,C,23,MIL,4,3,33,1,1,1.000,0,0,,1,1,1.000,1.000,0,0,,2,8,10,1,0,2,1,11,2
Zach Randolph,2003,PF,21,POR,7,4,205,32,61,.525,0,0,,32,61,.525,.525,33,37,.892,22,39,61,11,3,2,13,17,97
Å½eljko RebraÄa,2003,C,30,DET,4,0,29,6,17,.353,0,0,,6,17,.353,.353,5,7,.714,2,3,5,0,0,0,1,9,17
Michael Redd,2003,SG,23,MIL,6,0,128,21,52,.404,3,12,.250,18,40,.450,.433,13,14,.929,9,12,21,11,2,1,7,15,58
Clifford Robinson,2003,PF,36,DET,17,17,525,57,159,.358,22,59,.373,35,100,.350,.428,22,37,.595,14,32,46,49,16,13,28,62,158
David Robinson*,2003,C,37,SAS,23,23,539,64,118,.542,0,0,,64,118,.542,.542,52,78,.667,45,107,152,21,18,31,24,63,180
Rodney Rogers,2003,PF,31,NJN,20,0,350,45,121,.372,17,42,.405,28,79,.354,.442,27,38,.711,22,34,56,27,6,3,25,51,134
Malik Rose,2003,PF,28,SAS,24,0,560,75,179,.419,0,3,.000,75,176,.426,.419,72,94,.766,49,89,138,24,16,11,43,72,222
Kareem Rush,2003,PG,22,LAL,9,0,64,11,29,.379,4,11,.364,7,18,.389,.448,4,4,1.000,2,1,3,2,1,0,3,2,30
Arvydas Sabonis*,2003,C,38,POR,6,1,86,24,36,.667,0,0,,24,36,.667,.667,12,15,.800,6,18,24,5,4,4,6,14,60
John Salmons,2003,PG,23,PHI,6,0,16,0,1,.000,0,1,.000,0,0,,.000,0,2,.000,0,3,3,0,0,0,2,0,0
Jeryl Sasser,2003,SG,23,ORL,6,0,25,2,7,.286,1,4,.250,1,3,.333,.357,0,0,,1,4,5,1,1,1,1,1,5
Brian Scalabrine,2003,PF,24,NJN,7,0,20,2,4,.500,0,1,.000,2,3,.667,.500,0,0,,1,3,4,0,0,0,1,3,4
Brian Shaw,2003,PG,36,LAL,12,1,215,15,49,.306,6,26,.231,9,23,.391,.367,2,3,.667,1,37,38,24,4,5,9,18,38
Brian Skinner,2003,PF,26,PHI,8,0,38,1,6,.167,0,1,.000,1,5,.200,.167,4,4,1.000,3,3,6,0,0,1,2,6,6
Tamar Slay,2003,SG,22,NJN,6,0,11,1,4,.250,1,1,1.000,0,3,.000,.375,0,0,,0,0,0,0,0,0,2,1,3
Joe Smith,2003,SF,27,MIN,5,1,40,4,6,.667,0,0,,4,6,.667,.667,6,6,1.000,0,6,6,0,1,1,3,14,14
Steve Smith,2003,SG,33,SAS,9,0,66,5,24,.208,2,12,.167,3,12,.250,.250,4,4,1.000,1,6,7,6,1,0,2,3,16
Eric Snow,2003,PG,29,PHI,12,12,415,43,102,.422,1,10,.100,42,92,.457,.426,51,58,.879,9,31,40,67,18,0,30,47,138
DeShawn Stevenson,2003,SG,21,UTA,4,0,37,6,15,.400,0,2,.000,6,13,.462,.400,6,6,1.000,2,5,7,4,1,0,0,3,18
John Stockton*,2003,PG,40,UTA,5,5,149,18,39,.462,0,1,.000,18,38,.474,.462,20,20,1.000,5,11,16,26,8,1,14,13,56
Peja StojakoviÄ,2003,SF,25,SAC,12,12,486,97,202,.480,32,70,.457,65,132,.492,.559,51,60,.850,17,66,83,30,10,5,12,34,277
Damon Stoudamire,2003,PG,29,POR,7,6,232,36,79,.456,15,31,.484,21,48,.438,.551,20,21,.952,7,29,36,39,6,2,12,22,107
Amar'e Stoudemire,2003,PF,20,PHO,6,6,203,34,65,.523,1,1,1.000,33,64,.516,.531,16,28,.571,16,31,47,7,10,9,19,28,85
Erick Strickland,2003,SG,29,IND,5,0,42,6,14,.429,1,5,.200,5,9,.556,.464,8,10,.800,3,4,7,8,1,0,1,4,21
Rod Strickland,2003,PG,36,MIN,6,0,73,11,21,.524,0,0,,11,21,.524,.524,6,6,1.000,0,6,6,17,4,2,8,5,28
Wally Szczerbiak,2003,SF,25,MIN,6,6,252,29,61,.475,3,14,.214,26,47,.553,.500,26,30,.867,6,24,30,13,6,1,18,19,87
Kenny Thomas,2003,PF,25,PHI,12,12,389,54,101,.535,0,0,,54,101,.535,.535,19,29,.655,42,70,112,11,8,5,19,42,127
Tim Thomas,2003,SF,25,MIL,6,5,191,36,78,.462,12,21,.571,24,57,.421,.538,23,32,.719,8,21,29,8,3,6,8,27,107
Jamaal Tinsley,2003,PG,24,IND,6,6,185,20,35,.571,8,13,.615,12,22,.545,.686,3,6,.500,6,12,18,39,4,0,8,20,51
Robert Traylor,2003,C,25,NOH,6,0,94,10,22,.455,0,0,,10,22,.455,.455,1,4,.250,11,19,30,4,3,5,6,17,21
Gary Trent,2003,SF,28,MIN,6,0,42,5,14,.357,0,0,,5,14,.357,.357,4,6,.667,4,3,7,1,1,0,4,6,14
Hedo TÃ¼rkoÄlu,2003,SF,23,SAC,10,5,174,18,50,.360,4,14,.286,14,36,.389,.400,13,18,.722,5,24,29,14,12,5,5,19,53
Nick Van Exel,2003,SG,31,DAL,20,3,672,150,326,.460,44,112,.393,106,214,.495,.528,45,64,.703,18,50,68,82,12,0,39,47,389
Keith Van Horn,2003,PF,27,PHI,12,12,402,42,110,.382,14,32,.438,28,78,.359,.445,27,30,.900,24,66,90,9,10,2,26,41,125
Jacque Vaughn,2003,PG,27,ORL,7,6,131,12,33,.364,0,1,.000,12,32,.375,.364,10,13,.769,1,5,6,25,4,1,9,18,34
Jake Voskuhl,2003,C,25,PHO,6,0,98,12,17,.706,0,0,,12,17,.706,.706,12,13,.923,9,13,22,2,4,4,6,21,36
Antoine Walker,2003,PF,26,BOS,10,10,440,73,176,.415,16,45,.356,57,131,.435,.460,11,22,.500,20,67,87,43,17,4,37,44,173
Samaki Walker,2003,C,26,LAL,9,0,49,2,5,.400,0,0,,2,5,.400,.400,0,0,,4,9,13,2,1,2,3,11,4
Ben Wallace*,2003,C,28,DET,17,17,722,53,109,.486,0,1,.000,53,108,.491,.486,45,101,.446,86,191,277,28,42,52,15,50,151
Gerald Wallace,2003,SF,20,SAC,7,0,18,2,5,.400,0,0,,2,5,.400,.400,2,2,1.000,0,5,5,0,0,1,2,4,6
Rasheed Wallace,2003,PF,28,POR,7,7,260,44,97,.454,14,35,.400,30,62,.484,.526,20,28,.714,10,26,36,18,4,5,6,26,122
Chris Webber*,2003,PF,29,SAC,7,7,246,67,135,.496,0,3,.000,67,132,.508,.496,32,49,.653,18,40,58,25,10,8,23,25,166
Bonzi Wells,2003,SG,26,POR,7,7,268,49,124,.395,9,30,.300,40,94,.426,.431,26,39,.667,14,34,48,26,15,3,21,30,133
David Wesley,2003,SG,32,NOH,6,6,185,29,72,.403,14,34,.412,15,38,.395,.500,7,7,1.000,1,6,7,13,5,1,15,23,79
Chris Whitney,2003,PG,31,ORL,7,0,111,8,21,.381,4,9,.444,4,12,.333,.476,2,2,1.000,3,8,11,7,2,2,2,21,22
Mike Wilks,2003,PG,23,MIN,4,0,7,1,2,.500,1,1,1.000,0,1,.000,.750,0,0,,0,0,0,0,0,0,0,0,3
Aaron Williams,2003,C,31,NJN,19,0,340,50,106,.472,0,0,,50,106,.472,.472,23,31,.742,33,54,87,18,6,17,13,54,123
Eric Williams,2003,SF,30,BOS,10,2,310,33,88,.375,3,15,.200,30,73,.411,.392,27,34,.794,12,20,32,17,9,0,12,42,96
Monty Williams,2003,SF,31,PHI,10,0,96,8,23,.348,0,1,.000,8,22,.364,.348,3,4,.750,7,8,15,0,2,0,4,12,19
Scott Williams,2003,C,34,PHO,6,6,83,11,32,.344,0,0,,11,32,.344,.344,2,2,1.000,6,9,15,1,4,3,1,17,24
Walt Williams,2003,SF,32,DAL,15,3,227,32,81,.395,14,41,.341,18,40,.450,.481,7,7,1.000,12,31,43,15,5,12,17,28,85
Corliss Williamson,2003,SF,29,DET,15,0,233,37,90,.411,0,0,,37,90,.411,.411,43,58,.741,13,20,33,15,4,3,20,38,117
Kevin Willis,2003,C,40,SAS,18,0,91,21,40,.525,1,1,1.000,20,39,.513,.538,3,3,1.000,19,12,31,2,1,1,8,16,46
Loren Woods,2003,C,24,MIN,2,0,2,1,3,.333,0,0,,1,3,.333,.333,0,0,,1,0,1,0,0,0,0,0,2
Qyntel Woods,2003,PF,21,POR,4,0,18,3,9,.333,0,1,.000,3,8,.375,.333,1,2,.500,1,1,2,0,0,0,1,3,7
Metta World Peace,2003,SF,23,IND,6,6,252,35,90,.389,12,31,.387,23,59,.390,.456,32,40,.800,11,24,35,13,15,6,16,25,114
Malik Allen,2004,PF,25,MIA,10,0,138,22,49,.449,0,0,,22,49,.449,.449,6,9,.667,12,18,30,4,2,9,4,21,50
Rafer Alston,2004,PG,27,MIA,13,0,295,29,91,.319,12,52,.231,17,39,.436,.385,21,25,.840,4,25,29,22,5,1,10,22,91
Chris Andersen,2004,PF,25,DEN,5,0,34,3,9,.333,0,0,,3,9,.333,.333,0,0,,6,8,14,2,1,2,2,3,6
Kenny Anderson,2004,PG,33,IND,4,0,19,2,7,.286,0,0,,2,7,.286,.286,0,0,,0,1,1,1,1,0,5,3,4
Shandon Anderson,2004,SG,30,NYK,4,4,117,7,27,.259,2,7,.286,5,20,.250,.296,1,2,.500,5,4,9,11,4,1,8,19,17
Carmelo Anthony,2004,SF,19,DEN,4,4,143,21,64,.328,2,11,.182,19,53,.358,.344,16,20,.800,7,26,33,11,5,0,17,11,60
Brandon Armstrong,2004,SG,23,NJN,8,0,32,3,12,.250,0,1,.000,3,11,.273,.250,0,0,,1,1,2,3,1,0,0,4,6
Darrell Armstrong,2004,PG,35,NOH,7,0,150,8,34,.235,5,25,.200,3,9,.333,.309,3,3,1.000,6,9,15,16,6,0,13,10,24
Chucky Atkins,2004,PG,29,BOS,4,4,133,17,39,.436,3,10,.300,14,29,.483,.474,17,19,.895,3,11,14,15,3,0,10,2,54
Stacey Augmon,2004,SF,35,NOH,7,0,168,18,48,.375,0,1,.000,18,47,.383,.375,16,18,.889,4,15,19,7,6,1,13,13,52
Vin Baker,2004,PF,32,NYK,4,0,57,8,14,.571,0,0,,8,14,.571,.571,6,9,.667,6,6,12,1,3,2,2,8,22
Marcus Banks,2004,PG,22,BOS,4,0,60,7,16,.438,2,5,.400,5,11,.455,.500,4,4,1.000,1,6,7,7,2,1,3,9,20
Dana Barros,2004,SG,36,BOS,1,0,1,0,1,.000,0,0,,0,1,.000,.000,0,0,,0,0,0,0,0,0,0,0,0
Jon Barry,2004,SG,34,DEN,5,1,100,8,24,.333,3,9,.333,5,15,.333,.396,2,3,.667,4,14,18,10,3,0,4,4,21
Shane Battier,2004,SF,25,MEM,4,0,69,6,15,.400,3,7,.429,3,8,.375,.500,4,6,.667,6,6,12,1,0,1,4,17,19
Jonathan Bender,2004,SF,23,IND,16,0,200,28,69,.406,9,25,.360,19,44,.432,.471,12,16,.750,10,18,28,7,2,14,12,19,77
Mike Bibby,2004,PG,25,SAC,12,12,497,84,196,.429,24,55,.436,60,141,.426,.490,48,55,.873,9,41,50,84,23,5,35,40,240
Chauncey Billups,2004,PG,27,DET,23,23,881,110,286,.385,37,107,.346,73,179,.408,.449,121,136,.890,14,56,70,136,31,2,60,57,378
Mark Blount,2004,C,28,BOS,4,4,145,17,35,.486,0,0,,17,35,.486,.486,14,19,.737,10,27,37,4,6,8,9,17,48
Bruce Bowen,2004,SF,32,SAS,10,10,298,23,63,.365,11,29,.379,12,34,.353,.452,3,13,.231,6,23,29,10,4,3,4,24,60
Ryan Bowen,2004,PF,28,DEN,4,0,6,1,1,1.000,0,0,,1,1,1.000,1.000,0,0,,0,0,0,0,0,0,0,0,2
Earl Boykins,2004,SG,27,DEN,5,0,121,28,63,.444,5,14,.357,23,49,.469,.484,6,7,.857,6,6,12,19,5,1,6,6,67
Shawn Bradley,2004,C,31,DAL,2,0,3,0,0,,0,0,,0,0,,,0,0,,0,0,0,0,0,0,0,1,0
Devin Brown,2004,SG,25,SAS,9,0,130,18,37,.486,6,10,.600,12,27,.444,.568,10,17,.588,4,14,18,9,3,1,7,18,52
P.J. Brown,2004,PF,34,NOH,7,7,256,26,71,.366,0,0,,26,71,.366,.366,10,11,.909,29,39,68,15,3,11,13,16,62
Kobe Bryant*,2004,SG,25,LAL,22,22,973,190,460,.413,24,97,.247,166,363,.457,.439,135,166,.813,18,86,104,121,42,7,61,59,539
Rodney Buford,2004,SF,26,SAC,5,0,32,5,12,.417,1,3,.333,4,9,.444,.458,1,2,.500,0,5,5,3,2,0,0,2,12
Caron Butler,2004,SF,23,MIA,13,13,511,59,153,.386,2,11,.182,57,142,.401,.392,47,57,.825,18,92,110,31,28,7,23,45,167
Rasual Butler,2004,SF,24,MIA,10,0,58,9,22,.409,3,9,.333,6,13,.462,.477,0,0,,0,11,11,2,1,0,1,12,21
Marcus Camby,2004,C,29,DEN,5,5,194,27,55,.491,1,2,.500,26,53,.491,.500,8,14,.571,14,43,57,12,4,7,6,21,63
Elden Campbell,2004,C,35,DET,14,0,124,10,35,.286,0,0,,10,35,.286,.286,10,18,.556,10,15,25,10,6,9,9,28,30
Maurice Carter,2004,SG,27,NOH,1,0,2,0,1,.000,0,0,,0,1,.000,.000,0,0,,0,0,0,0,0,0,0,0,0
Sam Cassell,2004,PG,34,MIN,16,15,497,94,202,.465,25,60,.417,69,142,.486,.527,52,61,.852,3,37,40,70,12,3,43,53,265
Kelvin Cato,2004,PF,29,HOU,5,5,148,13,22,.591,0,0,,13,22,.591,.591,3,7,.429,14,20,34,2,5,4,5,18,29
Doug Christie,2004,SG,33,SAC,12,12,461,56,141,.397,13,33,.394,43,108,.398,.443,41,48,.854,17,57,74,47,22,5,22,35,166
Jason Collins,2004,C,25,NJN,11,11,266,14,38,.368,0,0,,14,38,.368,.368,12,16,.750,18,26,44,17,3,10,15,49,40
Brian Cook,2004,C,23,LAL,13,0,46,5,15,.333,0,0,,5,15,.333,.333,2,2,1.000,3,9,12,1,1,0,3,7,12
Austin Croshere,2004,PF,28,IND,13,2,214,19,55,.345,8,24,.333,11,31,.355,.418,17,21,.810,13,27,40,12,4,3,6,17,63
Marquis Daniels,2004,SG,23,DAL,5,5,184,32,75,.427,1,7,.143,31,68,.456,.433,14,22,.636,10,21,31,15,10,3,15,14,79
Baron Davis,2004,PG,24,NOH,7,7,260,43,114,.377,16,49,.327,27,65,.415,.447,25,33,.758,6,23,29,49,11,5,19,21,127
Ricky Davis,2004,SF,24,BOS,4,0,123,16,40,.400,4,10,.400,12,30,.400,.450,11,16,.688,3,9,12,14,2,0,12,7,47
Tony Delk,2004,SG,30,DAL,1,0,5,0,0,,0,0,,0,0,,,0,0,,0,1,1,2,1,0,0,0,0
Vlade Divac*,2004,C,35,SAC,12,12,235,31,71,.437,0,0,,31,71,.437,.437,17,23,.739,22,37,59,22,4,5,14,31,79
Michael Doleac,2004,C,26,DEN,5,0,49,5,10,.500,0,0,,5,10,.500,.500,0,0,,2,5,7,3,0,0,1,8,10
Tim Duncan*,2004,PF,27,SAS,10,10,405,83,159,.522,0,1,.000,83,158,.525,.522,55,87,.632,33,80,113,32,8,20,42,34,221
Francisco Elson,2004,C,27,DEN,4,0,60,7,12,.583,0,0,,7,12,.583,.583,1,2,.500,1,8,9,2,2,1,3,14,15
Michael Finley,2004,SG,30,DAL,5,5,196,26,68,.382,7,26,.269,19,42,.452,.434,6,10,.600,6,10,16,13,4,3,9,8,65
Derek Fisher,2004,SG,29,LAL,22,0,507,60,148,.405,23,55,.418,37,93,.398,.483,23,35,.657,10,46,56,49,18,0,19,47,166
Jeff Foster,2004,C,27,IND,16,13,307,25,43,.581,0,1,.000,25,42,.595,.581,8,10,.800,44,61,105,12,13,5,13,37,58
Rick Fox,2004,SF,34,LAL,16,3,145,8,20,.400,1,7,.143,7,13,.538,.425,1,2,.500,6,17,23,18,3,2,9,21,18
Steve Francis,2004,PG,26,HOU,5,5,222,30,70,.429,7,17,.412,23,53,.434,.479,29,40,.725,6,36,42,38,7,1,21,18,96
Dan Gadzuric,2004,C,25,MIL,1,0,9,2,4,.500,0,0,,2,4,.500,.500,0,1,.000,0,1,1,2,1,0,0,1,4
Kevin Garnett*,2004,PF,27,MIN,18,18,783,168,372,.452,5,16,.313,163,356,.458,.458,97,125,.776,39,224,263,92,24,41,75,57,438
Pau Gasol,2004,PF,23,MEM,4,4,134,28,49,.571,0,0,,28,49,.571,.571,18,20,.900,4,16,20,10,4,6,5,10,74
Devean George,2004,SF,26,LAL,22,19,470,43,100,.430,22,59,.373,21,41,.512,.540,13,20,.650,11,39,50,11,21,8,11,45,121
Manu GinÃ³bili*,2004,SG,26,SAS,10,0,280,42,94,.447,10,35,.286,32,59,.542,.500,36,44,.818,15,38,53,31,17,1,21,30,130
Brian Grant,2004,C,31,MIA,13,13,399,42,98,.429,0,1,.000,42,97,.433,.429,8,14,.571,45,67,112,10,7,8,18,52,92
Marcus Haislip,2004,PF,23,MIL,1,0,3,1,1,1.000,0,0,,1,1,1.000,1.000,0,0,,1,0,1,0,0,0,0,0,2
Darvin Ham,2004,SF,30,DET,22,0,108,8,16,.500,0,1,.000,8,15,.533,.500,0,0,,8,6,14,1,3,4,8,19,16
Richard Hamilton,2004,SG,25,DET,23,23,924,181,405,.447,15,39,.385,166,366,.454,.465,117,138,.848,32,74,106,97,27,1,72,72,494
Anfernee Hardaway,2004,SG,32,NYK,4,3,168,23,63,.365,5,14,.357,18,49,.367,.405,15,18,.833,4,14,18,23,6,1,10,8,66
Al Harrington,2004,PF,23,IND,16,2,427,60,140,.429,2,5,.400,58,135,.430,.436,30,55,.545,33,69,102,12,23,9,28,56,152
Lucious Harris,2004,PG,33,NJN,11,0,182,19,49,.388,3,12,.250,16,37,.432,.418,14,18,.778,10,12,22,10,7,1,5,16,55
Jason Hart,2004,PG,25,SAS,7,0,62,11,20,.550,0,0,,11,20,.550,.550,0,0,,0,3,3,1,5,0,1,5,22
Udonis Haslem,2004,PF,23,MIA,13,0,199,13,33,.394,0,0,,13,33,.394,.394,21,31,.677,18,26,44,3,5,3,3,22,47
Trenton Hassell,2004,SG,24,MIN,18,18,472,62,119,.521,1,2,.500,61,117,.521,.525,13,16,.813,21,23,44,27,10,7,16,42,138
NenÃª,2004,PF,21,DEN,5,5,132,16,36,.444,0,0,,16,36,.444,.444,7,13,.538,12,13,25,15,5,3,9,22,39
Fred Hoiberg,2004,SG,31,MIN,18,0,438,39,86,.453,22,48,.458,17,38,.447,.581,15,16,.938,9,57,66,23,16,0,8,29,115
Robert Horry,2004,PF,33,SAS,10,0,211,20,43,.465,8,22,.364,12,21,.571,.558,13,14,.929,25,38,63,9,8,2,10,31,61
Josh Howard,2004,SF,23,DAL,5,0,86,8,36,.222,1,5,.200,7,31,.226,.236,10,11,.909,17,15,32,4,6,6,7,12,27
Ryan Humphrey,2004,PF,24,MEM,3,0,5,1,1,1.000,0,0,,1,1,1.000,1.000,0,0,,1,1,2,0,0,0,0,0,2
Brandon Hunter,2004,PF,23,BOS,3,0,10,1,1,1.000,0,0,,1,1,1.000,1.000,0,0,,2,1,3,1,0,1,1,2,2
Lindsey Hunter,2004,SG,33,DET,23,0,273,19,65,.292,7,30,.233,12,35,.343,.346,11,12,.917,5,28,33,21,18,4,13,42,56
Jim Jackson,2004,SF,33,HOU,5,5,221,29,73,.397,8,29,.276,21,44,.477,.452,8,12,.667,3,49,52,10,5,1,9,9,74
Mark Jackson,2004,PG,38,HOU,5,0,38,1,6,.167,0,3,.000,1,3,.333,.167,0,0,,0,3,3,5,2,0,2,1,2
Mike James,2004,PG,28,DET,22,0,195,21,53,.396,6,14,.429,15,39,.385,.453,9,16,.563,7,19,26,24,5,0,15,23,57
Antawn Jamison,2004,SF,27,DAL,5,0,109,26,57,.456,2,8,.250,24,49,.490,.474,11,15,.733,15,10,25,2,5,2,5,15,65
Richard Jefferson,2004,SF,23,NJN,11,11,460,66,158,.418,9,33,.273,57,125,.456,.446,77,108,.713,14,55,69,42,14,8,43,35,218
Anthony Johnson,2004,PG,29,IND,16,0,332,25,69,.362,6,20,.300,19,49,.388,.406,17,22,.773,7,27,34,34,13,4,11,34,73
DerMarr Johnson,2004,SF,23,NYK,3,0,17,0,5,.000,0,3,.000,0,2,.000,.000,0,0,,0,2,2,2,0,1,0,2,0
Ervin Johnson,2004,C,36,MIN,18,16,356,19,38,.500,0,0,,19,38,.500,.500,10,16,.625,27,57,84,13,11,10,6,56,48
Damon Jones,2004,PG,27,MIL,5,5,144,18,34,.529,10,21,.476,8,13,.615,.676,4,6,.667,2,18,20,37,5,0,9,14,50
Eddie Jones,2004,SG,32,MIA,13,13,478,56,153,.366,20,67,.299,36,86,.419,.431,40,50,.800,3,44,47,29,18,11,19,37,172
Fred Jones,2004,SG,24,IND,14,0,263,25,51,.490,11,22,.500,14,29,.483,.598,5,7,.714,3,30,33,16,7,7,9,31,66
Jumaine Jones,2004,SG,24,BOS,2,0,28,2,6,.333,0,2,.000,2,4,.500,.333,0,0,,1,4,5,2,0,0,0,4,4
Jason Kidd*,2004,PG,30,NJN,11,11,474,43,129,.333,10,48,.208,33,81,.407,.372,43,53,.811,16,57,73,99,25,6,43,15,139
Kerry Kittles,2004,SG,29,NJN,11,11,415,60,134,.448,17,52,.327,43,82,.524,.511,21,34,.618,10,37,47,23,22,10,11,28,158
Brevin Knight,2004,PG,28,MIL,5,0,101,6,23,.261,0,0,,6,23,.261,.261,9,11,.818,3,8,11,17,14,1,7,12,21
Toni KukoÄ*,2004,PF,35,MIL,5,0,105,17,34,.500,4,12,.333,13,22,.591,.559,4,8,.500,4,10,14,4,3,2,6,11,42
Voshon Lenard,2004,SG,30,DEN,5,5,161,32,75,.427,11,24,.458,21,51,.412,.500,10,14,.714,4,9,13,12,4,0,9,13,85
George Lynch,2004,SF,33,NOH,7,7,147,25,57,.439,3,12,.250,22,45,.489,.465,5,8,.625,13,24,37,12,3,3,7,15,58
Mark Madsen,2004,C,28,MIN,17,0,222,17,32,.531,0,0,,17,32,.531,.531,13,29,.448,28,30,58,2,5,4,7,43,47
Jamaal Magloire,2004,C,25,NOH,7,7,239,28,67,.418,0,1,.000,28,66,.424,.418,21,28,.750,16,48,64,5,3,7,11,22,77
Karl Malone*,2004,PF,40,LAL,21,21,798,98,218,.450,0,1,.000,98,217,.452,.450,46,73,.630,37,148,185,72,24,2,47,65,242
Stephon Marbury,2004,PG,26,NYK,4,4,174,31,83,.373,6,20,.300,25,63,.397,.410,17,25,.680,5,12,17,26,7,0,14,9,85
Darrick Martin,2004,PG,32,MIN,16,3,182,14,51,.275,6,20,.300,8,31,.258,.333,16,20,.800,5,9,14,23,4,0,8,17,50
Kenyon Martin,2004,PF,26,NJN,11,11,409,81,152,.533,0,4,.000,81,148,.547,.533,48,64,.750,25,96,121,12,13,14,32,50,210
Desmond Mason,2004,SF,26,MIL,5,5,198,25,74,.338,0,2,.000,25,72,.347,.338,22,26,.846,4,20,24,12,4,2,12,16,72
Walter McCarty,2004,PF,29,BOS,4,4,127,11,23,.478,6,15,.400,5,8,.625,.609,0,0,,3,18,21,8,2,2,4,7,28
Stanislav Medvedenko,2004,PF,24,LAL,21,1,237,33,75,.440,0,0,,33,75,.440,.440,17,21,.810,23,30,53,10,4,4,5,50,83
Chris Mihm,2004,C,24,BOS,4,0,65,7,22,.318,0,0,,7,22,.318,.318,6,10,.600,8,10,18,0,4,4,3,12,20
Darko MiliÄiÄ,2004,C,18,DET,8,0,14,0,4,.000,0,0,,0,4,.000,.000,1,4,.250,1,2,3,1,1,0,3,1,1
Andre Miller,2004,PG,27,DEN,5,5,174,34,72,.472,0,2,.000,34,70,.486,.472,9,11,.818,15,8,23,16,8,0,10,16,77
Brad Miller,2004,PF,27,SAC,12,0,366,48,91,.527,1,7,.143,47,84,.560,.533,29,48,.604,30,74,104,38,9,11,20,46,126
Mike Miller,2004,SF,23,MEM,4,4,98,12,34,.353,5,13,.385,7,21,.333,.426,1,3,.333,0,12,12,3,5,0,5,4,30
Oliver Miller,2004,C,33,MIN,8,0,31,1,4,.250,0,0,,1,4,.250,.250,1,2,.500,0,5,5,1,0,3,3,13,3
Reggie Miller*,2004,SG,38,IND,16,16,455,45,112,.402,24,64,.375,21,48,.438,.509,47,51,.922,3,34,37,45,18,3,28,23,161
Yao Ming*,2004,C,23,HOU,5,5,185,31,68,.456,0,0,,31,68,.456,.456,13,17,.765,11,26,37,9,2,7,13,20,75
Cuttino Mobley,2004,SG,28,HOU,5,5,210,29,75,.387,6,21,.286,23,54,.426,.427,8,10,.800,5,19,24,14,3,3,18,14,72
Nazr Mohammed,2004,C,26,NYK,4,4,97,15,30,.500,0,0,,15,30,.500,.500,11,16,.688,10,13,23,1,6,3,7,18,41
Dikembe Mutombo*,2004,C,37,NYK,3,0,38,2,6,.333,0,0,,2,6,.333,.333,3,3,1.000,4,6,10,0,1,4,3,6,7
BoÅ¡tjan Nachbar,2004,SF,23,HOU,5,0,41,4,9,.444,1,3,.333,3,6,.500,.500,5,5,1.000,1,5,6,2,1,0,2,9,14
Eduardo NÃ¡jera,2004,SF,27,DAL,5,0,57,5,11,.455,0,0,,5,11,.455,.455,2,2,1.000,10,7,17,3,3,2,2,12,12
Steve Nash*,2004,PG,29,DAL,5,5,197,27,70,.386,6,16,.375,21,54,.389,.429,8,9,.889,6,20,26,45,4,0,12,14,68
Rasho NesteroviÄ,2004,C,27,SAS,10,10,261,29,67,.433,0,1,.000,29,66,.439,.433,1,6,.167,21,34,55,10,3,11,8,38,59
Dirk Nowitzki,2004,C,25,DAL,5,5,212,45,100,.450,7,15,.467,38,85,.447,.485,36,42,.857,13,46,59,7,7,13,6,16,133
Jermaine O'Neal,2004,PF,25,IND,16,16,604,115,272,.423,0,4,.000,115,268,.429,.423,77,110,.700,29,117,146,19,8,36,29,53,307
Shaquille O'Neal*,2004,C,31,LAL,22,22,917,182,307,.593,0,0,,182,307,.593,.593,109,254,.429,91,200,291,55,7,61,55,90,473
Lamar Odom,2004,PF,24,MIA,13,13,512,81,182,.445,8,26,.308,73,156,.468,.467,49,72,.681,32,76,108,37,15,10,42,58,219
Mehmet Okur,2004,PF,24,DET,22,0,252,31,66,.470,2,5,.400,29,61,.475,.485,18,26,.692,16,45,61,8,5,9,15,20,82
Michael Olowokandi,2004,C,28,MIN,15,2,224,12,37,.324,0,1,.000,12,36,.333,.324,7,8,.875,16,36,52,2,2,11,17,50,31
Bo Outlaw,2004,PF,32,MEM,4,0,61,0,7,.000,0,0,,0,7,.000,.000,2,4,.500,1,3,4,6,2,2,3,9,2
Scott Padgett,2004,PF,27,HOU,4,0,14,2,5,.400,1,3,.333,1,2,.500,.500,0,0,,1,2,3,0,1,1,1,1,5
Tony Parker,2004,PG,21,SAS,10,10,386,72,168,.429,17,43,.395,55,125,.440,.479,23,35,.657,5,16,21,70,13,1,31,15,184
Gary Payton*,2004,PG,35,LAL,22,22,772,68,186,.366,14,56,.250,54,130,.415,.403,21,28,.750,19,53,72,116,23,4,28,60,171
Anthony Peeler,2004,SG,34,SAC,11,0,236,19,63,.302,7,26,.269,12,37,.324,.357,5,6,.833,7,28,35,15,14,2,14,19,50
Eric Piatkowski,2004,SF,33,HOU,1,0,4,0,1,.000,0,0,,0,1,.000,.000,0,0,,0,1,1,0,0,0,0,1,0
Paul Pierce*,2004,SG,26,BOS,4,4,162,26,76,.342,5,17,.294,21,59,.356,.375,26,31,.839,6,29,35,10,5,4,25,12,83
Zoran PlaniniÄ,2004,SG,21,NJN,6,0,15,0,2,.000,0,1,.000,0,1,.000,.000,1,2,.500,0,1,1,2,0,0,2,2,1
Scot Pollard,2004,C,28,IND,3,0,13,0,2,.000,0,0,,0,2,.000,.000,2,4,.500,1,3,4,0,1,0,0,2,2
James Posey,2004,SG,27,MEM,4,4,130,15,37,.405,1,6,.167,14,31,.452,.419,19,21,.905,8,14,22,4,9,2,6,13,50
Tayshaun Prince,2004,SF,23,DET,23,23,795,87,212,.410,13,49,.265,74,163,.454,.441,41,55,.745,41,96,137,53,25,31,19,61,228
Michael Redd,2004,SG,24,MIL,5,5,192,34,83,.410,6,20,.300,28,63,.444,.446,16,21,.762,6,19,25,13,0,0,19,16,90
Rodney Rogers,2004,PF,32,NJN,11,0,228,23,72,.319,5,22,.227,18,50,.360,.354,16,20,.800,9,46,55,12,6,3,17,31,67
Malik Rose,2004,PF,29,SAS,7,0,58,4,16,.250,0,2,.000,4,14,.286,.250,2,4,.500,12,5,17,6,4,2,8,6,10
Kareem Rush,2004,SG,23,LAL,22,0,315,30,78,.385,20,50,.400,10,28,.357,.513,2,3,.667,0,16,16,17,10,3,14,33,82
Bryon Russell,2004,SF,33,LAL,6,0,16,0,3,.000,0,2,.000,0,1,.000,.000,0,0,,1,0,1,2,1,0,0,2,0
Daniel Santiago,2004,C,27,MIL,1,0,1,0,0,,0,0,,0,0,,,0,0,,0,0,0,0,0,0,0,1,0
Brian Scalabrine,2004,PF,25,NJN,9,0,73,11,17,.647,5,6,.833,6,11,.545,.794,3,6,.500,7,5,12,1,3,0,4,15,30
Brian Skinner,2004,C,27,MIL,5,3,94,11,21,.524,0,0,,11,21,.524,.524,5,12,.417,8,14,22,0,1,3,7,8,27
Tamar Slay,2004,SG,23,NJN,6,0,12,1,5,.200,0,1,.000,1,4,.250,.200,2,2,1.000,0,2,2,0,1,0,0,0,4
Jabari Smith,2004,C,26,SAC,4,0,10,1,2,.500,0,0,,1,2,.500,.500,3,4,.750,1,2,3,0,0,1,0,2,5
Joe Smith,2004,PF,28,MIL,5,5,175,27,55,.491,0,1,.000,27,54,.500,.491,12,13,.923,23,27,50,2,4,10,6,15,66
Steve Smith,2004,SG,34,NOH,5,0,46,12,26,.462,6,11,.545,6,15,.400,.577,2,3,.667,2,6,8,1,0,0,3,5,32
Darius Songaila,2004,PF,25,SAC,7,0,85,10,16,.625,0,0,,10,16,.625,.625,6,6,1.000,6,7,13,2,0,1,5,14,26
Latrell Sprewell,2004,SF,33,MIN,18,18,771,130,309,.421,37,96,.385,93,213,.437,.481,60,77,.779,11,68,79,72,29,12,47,35,357
Michael Stewart,2004,C,28,BOS,1,0,2,0,0,,0,0,,0,0,,,0,0,,0,0,0,0,0,0,0,2,0
Peja StojakoviÄ,2004,SF,26,SAC,12,12,517,76,198,.384,23,73,.315,53,125,.424,.442,35,39,.897,15,69,84,18,22,3,14,26,210
Erick Strickland,2004,PG,30,MIL,3,0,41,5,12,.417,0,5,.000,5,7,.714,.417,4,4,1.000,0,5,5,9,2,0,3,3,14
Mike Sweetney,2004,PF,21,NYK,4,0,57,6,11,.545,0,0,,6,11,.545,.545,4,6,.667,4,6,10,0,0,1,0,7,16
Stromile Swift,2004,PF,24,MEM,4,0,74,9,26,.346,0,0,,9,26,.346,.346,6,8,.750,6,13,19,3,3,6,3,6,24
Wally Szczerbiak,2004,SF,26,MIN,12,0,298,47,112,.420,10,29,.345,37,83,.446,.464,38,41,.927,9,30,39,20,6,2,24,31,142
Maurice Taylor,2004,PF,27,HOU,5,0,115,18,38,.474,0,0,,18,38,.474,.474,13,17,.765,5,11,16,5,0,1,7,20,49
Kurt Thomas,2004,PF,31,NYK,4,4,139,21,49,.429,0,0,,21,49,.429,.429,9,12,.750,9,37,46,6,7,3,10,17,51
Tim Thomas,2004,SF,26,NYK,1,1,22,4,10,.400,0,1,.000,4,9,.444,.400,4,5,.800,1,4,5,3,0,0,2,5,12
Jamaal Tinsley,2004,PG,25,IND,16,16,422,49,123,.398,16,54,.296,33,69,.478,.463,15,16,.938,6,40,46,80,28,3,31,56,129
Robert Traylor,2004,C,26,NOH,4,0,40,4,9,.444,0,0,,4,9,.444,.444,2,3,.667,1,9,10,1,3,1,2,8,10
Gary Trent,2004,C,29,MIN,13,0,71,8,25,.320,0,2,.000,8,23,.348,.320,5,8,.625,6,6,12,2,0,0,3,11,21
Jake Tsakalidis,2004,C,24,MEM,1,0,3,0,0,,0,0,,0,0,,,2,2,1.000,0,0,0,0,0,0,3,0,2
Hedo TÃ¼rkoÄlu,2004,SF,24,SAS,10,10,271,26,81,.321,14,42,.333,12,39,.308,.407,11,18,.611,5,40,45,15,9,1,16,20,77
Keith Van Horn,2004,SF,28,MIL,5,2,137,16,48,.333,4,11,.364,12,37,.324,.375,4,6,.667,5,18,23,7,7,3,10,15,40
Dwyane Wade,2004,PG,22,MIA,13,13,510,86,189,.455,3,8,.375,83,181,.459,.463,59,75,.787,16,36,52,73,17,4,54,45,234
Antoine Walker,2004,PF,27,DAL,5,5,140,22,61,.361,1,10,.100,21,51,.412,.369,4,7,.571,23,27,50,12,6,3,9,13,49
Samaki Walker,2004,PF,27,MIA,4,0,11,0,2,.000,0,0,,0,2,.000,.000,0,0,,0,1,1,0,0,0,0,2,0
Ben Wallace*,2004,C,29,DET,23,23,924,93,205,.454,0,3,.000,93,202,.460,.454,50,117,.427,95,233,328,44,44,56,37,58,236
Gerald Wallace,2004,SF,21,SAC,3,0,20,3,6,.500,0,0,,3,6,.500,.500,1,2,.500,0,2,2,1,1,1,3,4,7
Rasheed Wallace,2004,PF,29,DET,23,23,803,118,286,.413,17,70,.243,101,216,.468,.442,46,60,.767,47,132,179,37,13,45,43,78,299
Luke Walton,2004,PF,23,LAL,17,0,134,10,29,.345,5,13,.385,5,16,.313,.431,7,10,.700,5,17,22,26,7,2,14,24,32
Charlie Ward,2004,PG,33,SAS,5,0,13,4,6,.667,3,3,1.000,1,3,.333,.917,0,0,,0,0,0,1,2,0,2,2,11
Earl Watson,2004,PG,24,MEM,4,0,62,8,15,.533,0,3,.000,8,12,.667,.533,3,3,1.000,4,5,9,7,5,0,6,8,19
Clarence Weatherspoon,2004,PF,33,HOU,2,0,22,2,5,.400,0,0,,2,5,.400,.400,3,6,.500,2,2,4,0,0,0,0,3,7
Chris Webber*,2004,PF,30,SAC,12,12,446,90,199,.452,1,4,.250,89,195,.456,.455,40,65,.615,24,75,99,44,16,10,38,34,221
Bonzi Wells,2004,SG,27,MEM,4,0,94,19,37,.514,0,1,.000,19,36,.528,.514,9,14,.643,2,10,12,4,4,1,9,8,47
JiÅÃ­ Welsch,2004,SG,24,BOS,4,4,104,11,23,.478,1,4,.250,10,19,.526,.500,9,9,1.000,0,12,12,9,2,0,8,7,32
David Wesley,2004,SG,33,NOH,7,7,243,24,74,.324,11,30,.367,13,44,.295,.399,15,21,.714,1,15,16,17,5,0,16,21,74
David West,2004,PF,23,NOH,7,0,111,15,28,.536,0,0,,15,28,.536,.536,11,13,.846,8,22,30,8,2,4,7,10,41
Rodney White,2004,SF,23,DEN,4,0,26,4,15,.267,0,3,.000,4,12,.333,.267,0,0,,1,4,5,0,2,0,2,3,8
Mike Wilks,2004,PG,24,HOU,2,0,5,0,0,,0,0,,0,0,,,0,0,,0,0,0,1,0,0,1,0,0
Aaron Williams,2004,C,32,NJN,11,0,149,18,33,.545,0,0,,18,33,.545,.545,6,10,.600,7,15,22,4,0,7,15,41,42
Frank Williams,2004,PG,23,NYK,4,0,74,6,22,.273,4,13,.308,2,9,.222,.364,3,5,.600,1,1,2,5,3,0,4,13,19
Jason Williams,2004,PG,28,MEM,4,4,130,15,46,.326,6,21,.286,9,25,.360,.391,7,7,1.000,1,8,9,18,2,0,7,10,43
Scott Williams,2004,C,35,DAL,3,0,11,0,4,.000,0,0,,0,4,.000,.000,0,0,,2,2,4,0,0,1,0,3,0
Shammond Williams,2004,PG,28,NOH,3,0,18,2,5,.400,0,1,.000,2,4,.500,.400,3,4,.750,0,0,0,4,1,0,4,5,7
Corliss Williamson,2004,PF,30,DET,22,0,327,44,121,.364,0,1,.000,44,120,.367,.364,38,47,.809,20,29,49,15,6,3,24,59,126
Kevin Willis,2004,C,41,SAS,7,0,25,3,8,.375,0,1,.000,3,7,.429,.375,0,1,.000,0,6,6,0,1,0,0,5,6
Loren Woods,2004,C,25,MIA,1,0,2,0,0,,0,0,,0,0,,,0,0,,0,0,0,0,0,0,0,0,0
Metta World Peace,2004,SF,24,IND,15,15,584,98,259,.378,19,66,.288,79,193,.409,.415,61,85,.718,24,74,98,48,21,16,37,45,276
Lorenzen Wright,2004,C,28,MEM,4,4,100,10,23,.435,0,0,,10,23,.435,.435,2,6,.333,5,12,17,2,4,2,5,15,22
Wang Zhizhi,2004,C,26,MIA,3,0,7,0,0,,0,0,,0,0,,,0,0,,0,0,0,1,0,0,1,1,0
Ray Allen*,2005,SG,29,SEA,11,11,436,102,215,.474,31,82,.378,71,133,.534,.547,56,63,.889,12,35,47,43,14,4,34,22,291
Tony Allen,2005,SG,23,BOS,7,3,90,8,18,.444,0,0,,8,18,.444,.444,3,7,.429,4,8,12,2,3,2,5,17,19
Shandon Anderson,2005,SF,31,MIA,8,0,97,3,12,.250,0,1,.000,3,11,.273,.250,2,2,1.000,3,16,19,8,5,0,6,10,8
Carmelo Anthony,2005,SF,20,DEN,5,5,180,35,83,.422,0,1,.000,35,82,.427,.422,26,32,.813,14,13,27,10,3,1,13,20,96
Gilbert Arenas,2005,PG,23,WAS,10,10,450,73,194,.376,18,77,.234,55,117,.470,.423,72,94,.766,8,44,52,62,21,6,39,34,236
Darrell Armstrong,2005,PG,36,DAL,9,0,66,8,16,.500,2,8,.250,6,8,.750,.563,0,0,,3,1,4,9,3,2,2,9,18
Carlos Arroyo,2005,PG,25,DET,19,0,150,16,45,.356,0,1,.000,16,44,.364,.356,8,12,.667,1,9,10,39,4,2,10,19,40
Marcus Banks,2005,PG,23,BOS,7,0,106,13,29,.448,3,6,.500,10,23,.435,.500,3,6,.500,1,10,11,7,4,0,6,16,32
Leandro Barbosa,2005,PG,22,PHO,12,0,116,12,35,.343,4,10,.400,8,25,.320,.400,2,4,.500,5,12,17,12,3,0,5,8,30
Brent Barry,2005,SG,33,SAS,23,8,555,48,105,.457,28,66,.424,20,39,.513,.590,17,21,.810,13,43,56,44,15,4,27,44,141
Jon Barry,2005,SG,35,HOU,7,0,183,21,48,.438,11,23,.478,10,25,.400,.552,7,8,.875,1,28,29,9,5,0,6,13,60
Shane Battier,2005,SG,26,MEM,4,4,119,13,31,.419,1,7,.143,12,24,.500,.435,2,5,.400,10,17,27,6,2,4,4,14,29
Travis Best,2005,PG,32,NJN,4,0,82,9,22,.409,1,9,.111,8,13,.615,.432,8,9,.889,2,4,6,9,1,0,3,9,27
Mike Bibby,2005,PG,26,SAC,5,5,200,36,92,.391,5,23,.217,31,69,.449,.418,21,27,.778,5,17,22,33,7,2,13,11,98
Chauncey Billups,2005,PG,28,DET,25,25,985,145,339,.428,44,126,.349,101,213,.474,.493,133,149,.893,23,85,108,162,25,5,49,71,467
Steve Blake,2005,PG,24,WAS,4,0,17,1,4,.250,0,1,.000,1,3,.333,.250,0,0,,0,3,3,2,0,0,1,3,2
Mark Blount,2005,C,29,BOS,4,0,43,4,14,.286,0,0,,4,14,.286,.286,0,2,.000,3,3,6,1,0,0,5,6,8
Bruce Bowen,2005,SF,33,SAS,23,23,814,46,128,.359,29,67,.433,17,61,.279,.473,11,17,.647,9,57,66,36,11,13,15,77,132
Ryan Bowen,2005,SF,29,HOU,7,3,125,8,25,.320,0,0,,8,25,.320,.320,2,3,.667,7,7,14,6,6,0,6,23,18
Earl Boykins,2005,PG,28,DEN,5,1,152,27,68,.397,0,7,.000,27,61,.443,.397,17,19,.895,2,3,5,19,4,1,9,13,71
Shawn Bradley,2005,C,32,DAL,7,0,27,4,6,.667,0,0,,4,6,.667,.667,1,2,.500,4,2,6,0,0,2,0,7,9
Devin Brown,2005,SG,26,SAS,12,0,60,7,20,.350,3,7,.429,4,13,.308,.425,4,7,.571,1,6,7,3,1,0,1,3,21
Kwame Brown,2005,PF,22,WAS,3,0,60,5,13,.385,0,0,,5,13,.385,.385,5,9,.556,4,11,15,3,0,2,2,5,15
Greg Buckner,2005,SG,28,DEN,5,2,100,4,18,.222,2,9,.222,2,9,.222,.278,0,0,,1,15,16,5,2,1,3,14,10
Rodney Buford,2005,SF,27,NJN,3,0,4,0,0,,0,0,,0,0,,,0,0,,0,0,0,0,0,0,0,0,0
Antonio Burks,2005,PG,24,MEM,1,0,3,0,0,,0,0,,0,0,,,0,0,,0,0,0,1,0,0,0,0,0
Rasual Butler,2005,SF,25,MIA,12,1,182,22,59,.373,11,30,.367,11,29,.379,.466,1,3,.333,1,17,18,7,1,1,2,21,56
Marcus Camby,2005,C,30,DEN,5,5,184,17,41,.415,0,0,,17,41,.415,.415,17,27,.630,4,52,56,9,3,16,11,18,51
Elden Campbell,2005,C,36,DET,10,0,57,4,13,.308,0,0,,4,13,.308,.308,4,8,.500,3,15,18,5,2,0,4,13,12
Brian Cardinal,2005,PF,27,MEM,4,0,78,9,23,.391,0,4,.000,9,19,.474,.391,8,11,.727,2,10,12,2,3,0,1,11,26
Vince Carter,2005,SF,28,NJN,4,4,179,35,96,.365,6,19,.316,29,77,.377,.396,31,36,.861,9,25,34,23,9,0,15,17,107
Tyson Chandler,2005,C,22,CHI,6,0,172,19,40,.475,0,0,,19,40,.475,.475,32,46,.696,29,29,58,8,1,13,8,27,70
Jason Collins,2005,C,26,NJN,4,4,128,4,17,.235,0,0,,4,17,.235,.235,3,8,.375,9,17,26,1,2,0,5,19,11
Nick Collison,2005,C,24,SEA,11,0,218,37,61,.607,1,1,1.000,36,60,.600,.615,17,27,.630,22,33,55,5,3,5,6,40,92
Austin Croshere,2005,PF,29,IND,10,0,88,4,10,.400,2,4,.500,2,6,.333,.500,15,18,.833,7,10,17,0,4,1,6,10,25
Samuel Dalembert,2005,C,23,PHI,5,5,192,26,47,.553,0,0,,26,47,.553,.553,6,15,.400,18,46,64,2,2,7,9,19,58
Erick Dampier,2005,C,29,DAL,13,13,308,40,67,.597,0,1,.000,40,66,.606,.597,11,28,.393,51,46,97,7,7,18,12,54,91
Antonio Daniels,2005,PG,29,SEA,11,3,331,44,94,.468,4,14,.286,40,80,.500,.489,60,70,.857,4,27,31,49,11,0,11,13,152
Marquis Daniels,2005,SG,24,DAL,11,0,165,26,60,.433,1,6,.167,25,54,.463,.442,19,27,.704,15,19,34,14,6,3,13,15,72
Antonio Davis,2005,PF,36,CHI,6,6,175,20,46,.435,0,0,,20,46,.435,.435,17,23,.739,17,24,41,11,4,4,9,25,57
Dale Davis,2005,C,35,IND,13,13,311,26,58,.448,0,0,,26,58,.448,.448,17,25,.680,37,44,81,5,9,6,9,35,69
Josh Davis,2005,PF,24,PHI,2,0,4,0,1,.000,0,1,.000,0,0,,.000,0,0,,0,1,1,0,0,0,0,1,0
Ricky Davis,2005,SG,25,BOS,7,2,240,32,74,.432,3,9,.333,29,65,.446,.453,20,26,.769,5,20,25,14,9,2,21,23,87
Juan Dixon,2005,SG,26,WAS,10,0,219,41,101,.406,11,34,.324,30,67,.448,.460,21,25,.840,3,23,26,13,7,0,12,19,114
Michael Doleac,2005,C,27,MIA,9,0,65,7,16,.438,0,0,,7,16,.438,.438,2,2,1.000,2,12,14,0,1,1,3,13,16
Keyon Dooling,2005,PG,24,MIA,15,0,264,43,87,.494,7,19,.368,36,68,.529,.534,17,21,.810,1,15,16,25,6,1,14,34,110
Chris Duhon,2005,PG,22,CHI,6,5,159,11,37,.297,6,22,.273,5,15,.333,.378,9,11,.818,6,20,26,21,2,0,12,6,37
Tim Duncan*,2005,PF,28,SAS,23,23,869,197,425,.464,1,5,.200,196,420,.467,.465,147,205,.717,87,199,286,63,8,52,62,66,542
Ronald Dupree,2005,SF,24,DET,14,0,38,2,7,.286,0,0,,2,7,.286,.286,0,0,,2,4,6,0,0,0,1,6,4
Francisco Elson,2005,C,28,DEN,1,0,6,0,1,.000,0,0,,0,1,.000,.000,0,0,,0,3,3,0,0,0,0,0,0
Maurice Evans,2005,SG,26,SAC,3,0,56,6,10,.600,2,4,.500,4,6,.667,.700,4,5,.800,2,5,7,3,2,0,0,6,18
Reggie Evans,2005,PF,24,SEA,11,11,208,15,37,.405,0,0,,15,37,.405,.405,11,21,.524,27,54,81,5,5,3,11,32,41
Michael Finley,2005,SG,31,DAL,13,13,491,65,153,.425,24,61,.393,41,92,.446,.503,16,18,.889,13,43,56,28,17,0,13,32,170
Danny Fortson,2005,C,28,SEA,11,0,105,12,21,.571,0,0,,12,21,.571,.571,12,15,.800,5,21,26,0,3,1,13,42,36
Jeff Foster,2005,C,28,IND,13,0,245,31,52,.596,0,0,,31,52,.596,.596,15,21,.714,46,50,96,5,6,12,8,27,77
Lawrence Funderburke,2005,PF,34,CHI,5,0,28,1,2,.500,0,0,,1,2,.500,.500,1,2,.500,0,3,3,1,0,0,0,8,3
Pau Gasol,2005,PF,24,MEM,4,4,133,39,80,.488,1,1,1.000,38,79,.481,.494,6,12,.500,15,15,30,10,2,7,7,12,85
Eddie Gill,2005,PG,26,IND,7,0,45,5,16,.313,1,6,.167,4,10,.400,.344,13,15,.867,0,4,4,5,1,0,3,0,24
Manu GinÃ³bili*,2005,SG,27,SAS,23,15,772,145,286,.507,42,96,.438,103,190,.542,.580,147,185,.795,19,114,133,97,28,6,66,69,479
Ben Gordon,2005,SG,21,CHI,6,1,153,30,74,.405,7,22,.318,23,52,.442,.453,20,25,.800,6,10,16,15,5,2,13,18,87
Willie Green,2005,SG,23,PHI,5,0,63,8,18,.444,2,9,.222,6,9,.667,.500,9,10,.900,3,6,9,3,1,0,2,5,27
Adrian Griffin,2005,SF,30,CHI,5,0,86,15,29,.517,0,0,,15,29,.517,.517,4,5,.800,5,15,20,9,5,0,3,14,34
Darvin Ham,2005,SF,31,DET,14,0,24,1,3,.333,0,0,,1,3,.333,.333,2,2,1.000,3,0,3,0,0,0,0,2,4
Richard Hamilton,2005,SG,26,DET,25,25,1079,198,437,.453,10,34,.294,188,403,.467,.465,95,119,.798,30,78,108,107,21,3,78,79,501
Othella Harrington,2005,PF,31,CHI,6,6,103,21,42,.500,0,0,,21,42,.500,.500,6,11,.545,6,9,15,3,1,0,8,19,48
Devin Harris,2005,PG,21,DAL,9,0,80,7,16,.438,2,6,.333,5,10,.500,.500,6,9,.667,0,11,11,11,4,1,10,5,22
Udonis Haslem,2005,PF,24,MIA,15,15,543,52,106,.491,0,0,,52,106,.491,.491,34,46,.739,38,112,150,15,8,6,18,48,138
Brendan Haywood,2005,C,25,WAS,10,10,296,39,72,.542,0,0,,39,72,.542,.542,28,44,.636,35,41,76,10,14,20,10,40,106
Alan Henderson,2005,PF,32,DAL,9,0,92,8,14,.571,0,0,,8,14,.571,.571,2,2,1.000,11,6,17,0,2,2,2,15,18
NenÃª,2005,C,22,DEN,5,0,101,9,21,.429,0,0,,9,21,.429,.429,15,23,.652,9,16,25,2,2,2,5,16,33
Kirk Hinrich,2005,PG,24,CHI,6,6,213,45,100,.450,17,33,.515,28,67,.418,.535,20,29,.690,4,18,22,35,12,4,14,18,127
Robert Horry,2005,PF,34,SAS,23,0,618,73,163,.448,38,85,.447,35,78,.449,.564,30,41,.732,46,79,125,47,21,20,20,53,214
Eddie House,2005,PG,26,SAC,3,0,23,3,8,.375,1,1,1.000,2,7,.286,.438,2,2,1.000,1,1,2,4,0,0,1,2,9
Josh Howard,2005,SF,24,DAL,13,13,428,78,155,.503,4,16,.250,74,139,.532,.516,41,55,.745,33,63,96,24,11,7,28,60,201
Larry Hughes,2005,SG,26,WAS,10,10,401,68,181,.376,7,33,.212,61,148,.412,.395,64,77,.831,17,54,71,37,20,7,25,35,207
Lindsey Hunter,2005,SG,34,DET,25,0,374,36,113,.319,8,36,.222,28,77,.364,.354,16,22,.727,10,30,40,39,22,7,15,45,96
Steven Hunter,2005,C,23,PHO,15,0,213,24,43,.558,0,0,,24,43,.558,.558,12,20,.600,17,21,38,3,1,18,8,25,60
Andre Iguodala,2005,SG,21,PHI,5,5,192,20,43,.465,3,9,.333,17,34,.500,.500,6,12,.500,8,15,23,15,14,5,5,12,49
Allen Iverson*,2005,PG,29,PHI,5,5,238,59,126,.468,12,29,.414,47,97,.485,.516,26,29,.897,0,11,11,50,10,2,21,12,156
Bobby Jackson,2005,SG,31,SAC,5,0,79,10,37,.270,3,18,.167,7,19,.368,.311,3,3,1.000,2,4,6,9,1,1,3,5,26
Jim Jackson,2005,SF,34,PHO,15,6,474,63,129,.488,32,62,.516,31,67,.463,.612,7,8,.875,13,48,61,22,10,8,10,42,165
Marc Jackson,2005,C,30,PHI,5,0,65,5,20,.250,0,0,,5,20,.250,.250,7,11,.636,3,5,8,0,2,2,6,9,17
Stephen Jackson,2005,SF,26,IND,13,13,472,70,178,.393,20,63,.317,50,115,.435,.449,49,60,.817,7,43,50,29,25,6,34,39,209
Jerome James,2005,C,29,SEA,11,11,295,57,111,.514,0,0,,57,111,.514,.514,23,30,.767,33,42,75,5,6,20,14,48,137
Mike James,2005,PG,29,HOU,7,0,171,29,62,.468,0,9,.000,29,53,.547,.468,23,24,.958,2,11,13,16,6,2,10,17,81
Antawn Jamison,2005,PF,28,WAS,10,10,380,73,162,.451,17,34,.500,56,128,.438,.503,22,32,.688,16,47,63,12,7,4,16,24,185
Al Jefferson,2005,PF,20,BOS,7,0,136,17,41,.415,0,0,,17,41,.415,.415,9,12,.750,17,28,45,2,4,8,4,16,43
Richard Jefferson,2005,SF,24,NJN,4,1,140,20,50,.400,2,10,.200,18,40,.450,.420,21,31,.677,8,14,22,9,3,0,8,14,63
Jared Jeffries,2005,SF,23,WAS,10,10,247,24,49,.490,3,6,.500,21,43,.488,.520,13,17,.765,19,22,41,18,9,9,13,34,64
Anthony Johnson,2005,PG,30,IND,13,4,316,27,77,.351,8,23,.348,19,54,.352,.403,29,36,.806,4,34,38,66,13,5,25,28,91
DerMarr Johnson,2005,SG,24,DEN,4,2,78,11,20,.550,4,11,.364,7,9,.778,.650,3,3,1.000,3,5,8,3,2,2,0,9,29
Joe Johnson,2005,SF,23,PHO,9,9,355,63,125,.504,20,36,.556,43,89,.483,.584,23,33,.697,7,32,39,30,10,4,10,18,169
Dahntay Jones,2005,SG,24,MEM,3,0,71,8,21,.381,3,5,.600,5,16,.313,.452,3,4,.750,2,7,9,1,1,0,2,8,22
Damon Jones,2005,PG,28,MIA,15,15,498,62,129,.481,39,91,.429,23,38,.605,.632,18,30,.600,3,38,41,60,7,0,17,24,181
Eddie Jones,2005,SF,33,MIA,15,15,601,71,156,.455,32,80,.400,39,76,.513,.558,31,42,.738,10,77,87,39,18,9,22,57,205
Fred Jones,2005,SG,25,IND,13,0,234,16,54,.296,9,23,.391,7,31,.226,.380,12,13,.923,1,22,23,13,8,2,15,13,53
James Jones,2005,SF,24,IND,13,0,214,19,46,.413,10,25,.400,9,21,.429,.522,4,9,.444,5,22,27,10,7,7,4,18,52
Jason Kidd*,2005,PG,31,NJN,4,4,182,26,67,.388,11,30,.367,15,37,.405,.470,6,11,.545,10,26,36,29,10,0,9,16,69
Kyle Korver,2005,SF,23,PHI,5,5,147,8,28,.286,7,24,.292,1,4,.250,.411,2,2,1.000,3,10,13,8,4,1,8,18,25
Nenad KrstiÄ,2005,PF,21,NJN,4,4,154,27,48,.563,0,0,,27,48,.563,.563,19,24,.792,10,20,30,7,1,2,6,20,73
Christian Laettner,2005,PF,35,MIA,13,0,136,12,24,.500,0,1,.000,12,23,.522,.500,5,6,.833,3,22,25,7,4,0,6,17,29
Raef LaFrentz,2005,PF,28,BOS,7,7,185,16,41,.390,8,16,.500,8,25,.320,.488,8,10,.800,6,28,34,8,6,12,7,27,48
Rashard Lewis,2005,SF,25,SEA,8,8,312,43,106,.406,5,25,.200,38,81,.469,.429,44,50,.880,11,32,43,13,3,3,16,25,135
Shawn Marion,2005,PF,26,PHO,15,15,635,108,223,.484,18,43,.419,90,180,.500,.525,30,39,.769,46,131,177,23,21,26,21,47,264
Kenyon Martin,2005,PF,27,DEN,5,5,164,27,58,.466,0,1,.000,27,57,.474,.466,8,13,.615,7,21,28,6,5,5,7,22,62
Tony Massenburg,2005,PF,37,SAS,9,0,28,1,6,.167,0,0,,1,6,.167,.167,1,2,.500,4,7,11,0,0,0,0,2,3
Walter McCarty,2005,PF,30,PHO,8,0,55,2,9,.222,2,6,.333,0,3,.000,.333,0,2,.000,0,6,6,3,2,2,1,13,6
Antonio McDyess,2005,PF,30,DET,25,0,494,88,181,.486,0,0,,88,181,.486,.486,25,36,.694,46,101,147,19,14,23,25,78,201
Tracy McGrady*,2005,SF,25,HOU,7,7,301,78,171,.456,17,46,.370,61,125,.488,.506,42,51,.824,12,40,52,47,11,10,26,20,215
Aaron McKie,2005,SG,32,PHI,5,0,85,3,7,.429,1,3,.333,2,4,.500,.500,0,0,,1,11,12,5,4,0,1,9,7
Darko MiliÄiÄ,2005,C,19,DET,9,0,21,2,7,.286,0,0,,2,7,.286,.286,1,1,1.000,1,3,4,1,0,1,1,3,5
Andre Miller,2005,PG,28,DEN,5,5,184,28,66,.424,2,4,.500,26,62,.419,.439,23,32,.719,9,17,26,26,10,1,12,22,81
Brad Miller,2005,C,28,SAC,5,4,139,23,40,.575,0,2,.000,23,38,.605,.575,10,14,.714,8,11,19,16,1,3,9,21,56
Mike Miller,2005,SF,24,MEM,4,4,110,18,37,.486,8,17,.471,10,20,.500,.595,4,4,1.000,0,10,10,11,0,3,5,7,48
Reggie Miller*,2005,SG,39,IND,13,13,430,62,143,.434,21,66,.318,41,77,.532,.507,48,51,.941,4,36,40,20,10,1,21,28,193
Yao Ming*,2005,C,24,HOU,7,7,220,55,84,.655,0,0,,55,84,.655,.655,40,55,.727,23,31,54,5,2,19,19,31,150
Cuttino Mobley,2005,SG,29,SAC,5,5,159,31,70,.443,7,25,.280,24,45,.533,.493,5,7,.714,4,10,14,9,6,2,6,13,74
Nazr Mohammed,2005,C,27,SAS,23,23,528,66,125,.528,1,1,1.000,65,124,.524,.532,30,47,.638,75,79,154,8,14,23,24,65,163
Alonzo Mourning*,2005,C,34,MIA,15,2,254,31,44,.705,0,0,,31,44,.705,.705,29,52,.558,21,51,72,5,5,33,22,49,91
Ronald Murray,2005,SG,25,SEA,4,0,62,4,19,.211,0,2,.000,4,17,.235,.211,4,7,.571,2,4,6,5,0,2,2,8,12
Dikembe Mutombo*,2005,C,38,HOU,7,0,101,6,11,.545,0,0,,6,11,.545,.545,10,13,.769,11,24,35,2,2,7,7,15,22
Eduardo NÃ¡jera,2005,PF,28,DEN,2,0,13,0,2,.000,0,0,,0,2,.000,.000,0,0,,1,1,2,1,0,0,1,1,0
Steve Nash*,2005,PG,30,PHO,15,15,610,140,269,.520,21,54,.389,119,215,.553,.559,57,62,.919,9,63,72,170,14,3,70,36,358
Rasho NesteroviÄ,2005,C,28,SAS,15,0,114,5,12,.417,0,0,,5,12,.417,.417,0,2,.000,11,15,26,2,1,5,4,16,10
AndrÃ©s Nocioni,2005,SF,25,CHI,6,6,202,27,67,.403,6,17,.353,21,50,.420,.448,17,23,.739,8,41,49,14,1,6,11,20,77
Moochie Norris,2005,PG,31,HOU,2,0,7,0,1,.000,0,0,,0,1,.000,.000,0,0,,0,0,0,0,0,0,0,0,0
Dirk Nowitzki,2005,PF,26,DAL,13,13,551,103,256,.402,10,30,.333,93,226,.412,.422,92,111,.829,25,106,131,43,18,21,33,42,308
Jermaine O'Neal,2005,PF,26,IND,13,13,476,77,211,.365,0,3,.000,77,208,.370,.365,54,72,.750,21,83,104,29,7,34,36,48,208
Shaquille O'Neal*,2005,C,32,MIA,13,13,431,101,181,.558,0,0,,101,181,.558,.558,50,106,.472,19,83,102,25,5,19,42,52,252
Greg Ostertag,2005,C,31,SAC,2,0,26,3,3,1.000,0,0,,3,3,1.000,1.000,0,0,,4,5,9,0,1,2,2,4,6
Bo Outlaw,2005,PF,33,PHO,1,0,2,0,1,.000,0,0,,0,1,.000,.000,0,0,,0,0,0,1,1,0,0,0,0
Scott Padgett,2005,PF,28,HOU,7,4,109,9,24,.375,5,12,.417,4,12,.333,.479,2,2,1.000,9,10,19,4,3,2,3,18,25
Jannero Pargo,2005,PG,25,CHI,5,0,76,18,51,.353,13,32,.406,5,19,.263,.480,3,5,.600,1,4,5,10,3,0,8,14,52
Tony Parker,2005,PG,22,SAS,23,23,858,166,366,.454,9,48,.188,157,318,.494,.466,55,87,.632,13,53,66,100,17,2,71,69,396
Gary Payton*,2005,PG,36,BOS,7,7,239,33,74,.446,1,14,.071,32,60,.533,.453,5,6,.833,8,21,29,32,6,1,11,10,72
Anthony Peeler,2005,SG,35,WAS,7,0,43,1,9,.111,0,3,.000,1,6,.167,.111,2,2,1.000,0,7,7,3,1,0,3,4,4
Kendrick Perkins,2005,C,20,BOS,6,0,28,4,5,.800,0,0,,4,5,.800,.800,1,3,.333,3,3,6,0,0,3,3,7,9
Wesley Person,2005,SF,33,DEN,4,0,54,6,14,.429,3,8,.375,3,6,.500,.536,0,0,,1,0,1,1,1,0,1,0,15
Eric Piatkowski,2005,SG,34,CHI,5,0,66,6,19,.316,5,13,.385,1,6,.167,.447,6,7,.857,1,8,9,3,4,1,1,3,23
Paul Pierce*,2005,SF,27,BOS,7,7,277,47,93,.505,7,27,.259,40,66,.606,.543,59,68,.868,7,47,54,32,13,10,19,18,160
Zoran PlaniniÄ,2005,PG,22,NJN,3,0,3,0,0,,0,0,,0,0,,,0,0,,0,0,0,0,0,0,0,0,0
Scot Pollard,2005,C,29,IND,9,0,67,6,15,.400,0,0,,6,15,.400,.400,1,2,.500,4,7,11,1,1,0,4,9,13
James Posey,2005,SF,28,MEM,4,0,100,11,25,.440,7,15,.467,4,10,.400,.580,10,13,.769,1,12,13,4,2,1,5,14,39
Vitaly Potapenko,2005,C,29,SEA,5,0,37,5,10,.500,0,0,,5,10,.500,.500,0,0,,3,4,7,0,0,0,0,8,10
Tayshaun Prince,2005,SF,24,DET,25,25,1023,133,307,.433,22,60,.367,111,247,.449,.469,48,60,.800,56,102,158,83,26,9,37,50,336
Laron Profit,2005,SF,27,WAS,3,0,5,0,2,.000,0,0,,0,2,.000,.000,0,0,,0,1,1,1,0,0,0,0,0
Vladimir RadmanoviÄ,2005,PF,24,SEA,6,0,122,13,35,.371,5,21,.238,8,14,.571,.443,1,2,.500,1,17,18,3,4,3,6,9,32
Justin Reed,2005,SF,23,BOS,6,0,22,2,6,.333,0,2,.000,2,4,.500,.333,3,4,.750,0,1,1,0,0,0,2,2,7
Jared Reiner,2005,C,22,CHI,3,0,7,0,1,.000,0,0,,0,1,.000,.000,0,0,,2,1,3,0,0,0,1,3,0
Quentin Richardson,2005,SG,24,PHO,15,15,564,62,154,.403,32,82,.390,30,72,.417,.506,23,36,.639,24,53,77,25,19,3,15,53,179
Luke Ridnour,2005,PG,23,SEA,11,11,378,42,107,.393,4,17,.235,38,90,.422,.411,19,20,.950,10,26,36,47,13,8,18,23,107
Clifford Robinson,2005,PF,38,NJN,4,0,71,11,27,.407,4,14,.286,7,13,.538,.481,2,2,1.000,2,8,10,5,3,1,0,20,28
Glenn Robinson,2005,SF,32,SAS,13,0,113,16,45,.356,3,10,.300,13,35,.371,.389,15,17,.882,2,19,21,1,3,7,6,20,50
Rodney Rogers,2005,PF,33,PHI,4,0,49,6,13,.462,3,8,.375,3,5,.600,.577,5,7,.714,0,4,4,1,0,2,1,4,20
Michael Ruffin,2005,C,28,WAS,9,0,156,7,10,.700,0,0,,7,10,.700,.700,9,16,.563,15,22,37,9,3,3,4,33,23
Bryon Russell,2005,SF,34,DEN,3,0,9,0,1,.000,0,1,.000,0,0,,.000,3,3,1.000,0,0,0,0,0,0,0,0,3
John Salmons,2005,SG,25,PHI,2,0,4,0,0,,0,0,,0,0,,,0,0,,0,0,0,1,0,0,0,0,0
Brian Scalabrine,2005,PF,26,NJN,4,3,61,2,11,.182,1,4,.250,1,7,.143,.227,4,4,1.000,2,5,7,2,1,2,4,6,9
Brian Skinner,2005,C,28,SAC,4,1,47,4,8,.500,0,0,,4,8,.500,.500,0,0,,6,5,11,2,2,4,5,5,8
Jabari Smith,2005,PF,27,NJN,3,0,4,0,0,,0,0,,0,0,,,0,0,,0,0,0,0,0,0,0,2,0
Steve Smith,2005,SG,35,MIA,3,0,8,0,2,.000,0,0,,0,2,.000,.000,0,0,,0,0,0,0,0,0,0,0,0
Darius Songaila,2005,PF,26,SAC,5,0,75,8,19,.421,0,0,,8,19,.421,.421,4,5,.800,6,8,14,3,2,1,2,14,20
Jerry Stackhouse,2005,SG,30,DAL,13,0,403,68,176,.386,16,40,.400,52,136,.382,.432,57,66,.864,20,33,53,30,8,3,21,22,209
Peja StojakoviÄ,2005,SF,27,SAC,5,5,203,39,83,.470,11,30,.367,28,53,.528,.536,21,22,.955,6,20,26,7,4,1,2,15,110
Amar'e Stoudemire,2005,C,22,PHO,15,15,601,153,284,.539,0,3,.000,153,281,.544,.539,143,183,.781,60,100,160,18,10,30,47,59,449
Bob Sura,2005,PG,31,HOU,7,7,182,20,46,.435,7,13,.538,13,33,.394,.511,8,12,.667,6,21,27,14,7,0,11,15,55
Stromile Swift,2005,PF,25,MEM,3,0,48,12,20,.600,0,0,,12,20,.600,.600,4,7,.571,7,7,14,1,1,0,2,3,28
Jason Terry,2005,PG,27,DAL,13,13,501,81,160,.506,27,55,.491,54,105,.514,.591,38,43,.884,9,45,54,60,17,7,30,28,227
Billy Thomas,2005,SF,29,NJN,2,0,2,0,1,.000,0,0,,0,1,.000,.000,0,0,,0,0,0,0,0,0,0,0,0
Etan Thomas,2005,C,26,WAS,8,0,126,19,29,.655,0,0,,19,29,.655,.655,10,22,.455,12,24,36,2,0,7,9,23,48
Kenny Thomas,2005,PF,27,SAC,5,5,153,23,45,.511,0,0,,23,45,.511,.511,14,20,.700,17,27,44,12,4,2,8,22,60
Jamaal Tinsley,2005,PG,26,IND,9,9,247,32,89,.360,2,18,.111,30,71,.423,.371,12,21,.571,6,24,30,51,14,3,27,31,78
Beno Udrih,2005,PG,22,SAS,21,0,241,28,78,.359,10,37,.270,18,41,.439,.423,12,14,.857,4,13,17,22,9,1,20,20,78
Keith Van Horn,2005,PF,29,DAL,3,0,33,7,15,.467,0,4,.000,7,11,.636,.467,8,9,.889,3,3,6,1,1,0,1,6,22
Dwyane Wade,2005,SG,23,MIA,14,14,571,136,281,.484,1,10,.100,135,271,.498,.486,111,139,.799,23,57,80,93,22,16,62,43,384
Antoine Walker,2005,PF,28,BOS,6,6,224,43,104,.413,7,19,.368,36,85,.424,.447,7,11,.636,16,28,44,14,7,6,18,19,100
Ben Wallace*,2005,C,30,DET,25,25,979,102,212,.481,0,4,.000,102,208,.490,.481,47,102,.461,95,187,282,25,43,59,30,65,251
Rasheed Wallace,2005,PF,30,DET,25,25,826,136,310,.439,29,86,.337,107,224,.478,.485,40,54,.741,39,134,173,32,26,44,38,95,341
Earl Watson,2005,PG,25,MEM,4,0,74,8,24,.333,1,9,.111,7,15,.467,.354,2,2,1.000,3,7,10,15,3,1,2,11,19
Clarence Weatherspoon,2005,PF,34,HOU,1,0,1,0,0,,0,0,,0,0,,,0,0,,0,0,0,0,0,0,0,1,0
Chris Webber*,2005,PF,31,PHI,5,5,186,39,95,.411,5,14,.357,34,81,.420,.437,12,16,.750,12,17,29,14,6,1,11,20,95
Bonzi Wells,2005,SG,28,MEM,2,0,25,4,9,.444,0,0,,4,9,.444,.444,6,6,1.000,0,4,4,3,2,1,1,1,14
David Wesley,2005,SG,34,HOU,7,7,280,19,54,.352,10,21,.476,9,33,.273,.444,9,13,.692,4,17,21,23,9,1,9,20,57
Delonte West,2005,SG,21,BOS,7,3,115,11,21,.524,5,11,.455,6,10,.600,.643,2,4,.500,2,7,9,4,7,1,2,17,29
Damien Wilkins,2005,SF,25,SEA,7,0,136,16,36,.444,3,11,.273,13,25,.520,.486,4,9,.444,9,9,18,3,10,1,8,17,39
Jason Williams,2005,PG,29,MEM,4,4,114,28,53,.528,10,21,.476,18,32,.563,.623,2,2,1.000,1,8,9,21,6,0,8,7,68
Corliss Williamson,2005,PF,31,SAC,5,0,40,6,16,.375,0,1,.000,6,15,.400,.375,14,18,.778,4,2,6,3,1,2,4,11,26
Lorenzen Wright,2005,C,29,MEM,4,4,85,16,28,.571,0,0,,16,28,.571,.571,1,2,.500,6,14,20,9,1,1,2,10,33
Shareef Abdur-Rahim,2006,PF,29,SAC,6,0,129,23,43,.535,0,3,.000,23,40,.575,.535,9,15,.600,8,21,29,7,2,0,13,27,55
Malik Allen,2006,PF,27,CHI,6,6,116,14,30,.467,0,0,,14,30,.467,.467,0,1,.000,5,13,18,7,2,6,10,16,28
Derek Anderson,2006,SG,31,MIA,8,0,66,6,20,.300,5,14,.357,1,6,.167,.425,7,8,.875,0,9,9,5,2,0,3,13,24
Shandon Anderson,2006,SF,32,MIA,13,0,90,4,13,.308,1,3,.333,3,10,.300,.346,4,6,.667,3,9,12,4,0,1,6,8,13
Carmelo Anthony,2006,SF,21,DEN,5,5,193,33,99,.333,0,4,.000,33,95,.347,.333,39,52,.750,12,21,33,14,4,1,15,20,105
Gilbert Arenas,2006,PG,24,WAS,6,6,284,65,140,.464,20,46,.435,45,94,.479,.536,54,70,.771,7,26,33,32,13,4,20,21,204
Darrell Armstrong,2006,PG,37,DAL,11,0,47,3,15,.200,0,7,.000,3,8,.375,.200,2,2,1.000,1,6,7,2,3,1,1,9,8
Chucky Atkins,2006,PG,31,MEM,4,4,103,15,37,.405,4,11,.364,11,26,.423,.459,5,8,.625,0,3,3,12,2,0,4,15,39
Leandro Barbosa,2006,SG,23,PHO,20,3,632,103,219,.470,27,69,.391,76,150,.507,.532,50,58,.862,5,27,32,54,15,4,29,66,283
Brent Barry,2006,SG,34,SAS,13,2,301,34,61,.557,17,34,.500,17,27,.630,.697,16,21,.762,3,29,32,22,9,3,9,29,101
Shane Battier,2006,SF,27,MEM,4,4,129,10,20,.500,2,7,.286,8,13,.615,.550,2,6,.333,7,16,23,2,4,2,8,16,24
Charlie Bell,2006,SG,26,MIL,5,0,108,17,43,.395,5,11,.455,12,32,.375,.453,7,7,1.000,2,1,3,7,3,2,4,15,46
Raja Bell,2006,SG,29,PHO,17,17,673,79,165,.479,40,86,.465,39,79,.494,.600,34,41,.829,8,40,48,37,11,4,10,70,232
Mike Bibby,2006,PG,27,SAC,6,6,255,32,92,.348,9,26,.346,23,66,.348,.397,27,30,.900,6,17,23,31,9,0,18,17,100
Chauncey Billups,2006,PG,29,DET,18,18,705,93,229,.406,32,94,.340,61,135,.452,.476,105,116,.905,7,54,61,117,22,2,43,43,323
Andrew Bogut,2006,PF,21,MIL,5,5,172,20,46,.435,0,0,,20,46,.435,.435,3,8,.375,9,22,31,17,3,0,8,21,43
Bruce Bowen,2006,SF,34,SAS,13,13,442,32,61,.525,15,30,.500,17,31,.548,.648,1,2,.500,6,22,28,16,11,8,9,42,80
Earl Boykins,2006,PG,29,DEN,5,0,140,19,59,.322,4,19,.211,15,40,.375,.356,13,17,.765,3,4,7,20,4,0,3,6,55
Elton Brand,2006,PF,26,LAC,12,12,517,124,225,.551,0,1,.000,124,224,.554,.551,57,76,.750,51,72,123,48,11,31,29,34,305
Kwame Brown,2006,C,23,LAL,7,7,225,34,65,.523,0,0,,34,65,.523,.523,22,31,.710,17,29,46,7,2,6,12,21,90
Kobe Bryant*,2006,SG,27,LAL,7,7,314,72,145,.497,14,35,.400,58,110,.527,.545,37,48,.771,4,40,44,36,8,3,33,25,195
Greg Buckner,2006,SG,29,DEN,5,4,137,23,55,.418,10,32,.313,13,23,.565,.509,7,8,.875,3,11,14,6,3,1,1,12,63
Pat Burke,2006,C,32,PHO,3,0,7,2,4,.500,1,2,.500,1,2,.500,.625,0,1,.000,1,2,3,0,0,1,0,0,5
Antonio Burks,2006,PG,25,MEM,2,0,13,1,1,1.000,0,0,,1,1,1.000,1.000,1,2,.500,0,1,1,2,1,0,0,2,3
Caron Butler,2006,SF,25,WAS,6,6,262,42,101,.416,3,14,.214,39,87,.448,.431,24,29,.828,16,47,63,16,12,4,14,31,111
Andrew Bynum,2006,C,18,LAL,1,0,2,0,1,.000,0,0,,0,1,.000,.000,0,0,,0,0,0,0,0,0,0,0,0
Marcus Camby,2006,C,31,DEN,5,5,175,26,62,.419,0,0,,26,62,.419,.419,5,9,.556,13,42,55,11,4,14,4,14,57
Brian Cardinal,2006,PF,28,MEM,3,0,22,1,2,.500,1,2,.500,0,0,,.750,0,0,,1,3,4,1,1,0,0,2,3
Vince Carter,2006,SG,29,NJN,11,11,450,113,244,.463,14,58,.241,99,186,.532,.492,86,108,.796,16,61,77,58,20,6,26,34,326
Sam Cassell,2006,PG,36,LAC,12,12,404,73,167,.437,15,43,.349,58,124,.468,.482,55,68,.809,9,39,48,69,8,2,28,35,216
Kelvin Cato,2006,C,31,DET,4,0,15,3,5,.600,0,0,,3,5,.600,.600,0,0,,3,4,7,0,0,0,0,2,6
Tyson Chandler,2006,C,23,CHI,6,0,104,4,6,.667,0,0,,4,6,.667,.667,3,10,.300,8,19,27,3,2,2,6,29,11
Jason Collins,2006,C,27,NJN,11,11,302,9,25,.360,0,0,,9,25,.360,.360,13,22,.591,20,35,55,3,5,2,9,55,31
Brian Cook,2006,PF,25,LAL,7,0,78,18,46,.391,4,11,.364,14,35,.400,.435,4,4,1.000,11,11,22,8,1,0,3,15,44
Austin Croshere,2006,PF,30,IND,6,2,175,12,38,.316,9,23,.391,3,15,.200,.434,16,18,.889,5,17,22,7,5,0,6,11,49
Erick Dampier,2006,C,30,DAL,19,2,454,34,63,.540,0,1,.000,34,62,.548,.540,27,44,.614,55,72,127,6,11,24,12,75,95
Antonio Daniels,2006,SG,30,WAS,6,0,216,28,52,.538,3,11,.273,25,41,.610,.567,20,22,.909,2,15,17,20,3,1,10,4,79
Marquis Daniels,2006,SG,25,DAL,20,0,222,25,56,.446,2,5,.400,23,51,.451,.464,16,21,.762,10,11,21,26,5,1,12,26,68
Dale Davis,2006,C,36,DET,8,0,36,0,6,.000,0,0,,0,6,.000,.000,2,4,.500,1,8,9,1,0,0,3,11,2
Carlos Delfino,2006,SG,23,DET,8,0,32,1,6,.167,1,2,.500,0,4,.000,.250,2,2,1.000,0,4,4,2,1,0,6,4,5
Tony Delk,2006,PG,32,DET,16,0,138,19,47,.404,3,15,.200,16,32,.500,.436,7,10,.700,4,14,18,8,6,0,4,14,48
Luol Deng,2006,SF,20,CHI,6,0,180,24,56,.429,1,5,.200,23,51,.451,.438,12,21,.571,8,21,29,3,5,4,5,13,61
Boris Diaw,2006,PF,23,PHO,20,20,796,152,289,.526,3,7,.429,149,282,.528,.531,67,88,.761,39,94,133,104,18,22,55,64,374
DeSagana Diop,2006,C,24,DAL,22,18,407,24,39,.615,0,0,,24,39,.615,.615,11,18,.611,40,69,109,2,14,28,11,81,59
Michael Doleac,2006,C,28,MIA,8,0,72,7,13,.538,0,0,,7,13,.538,.538,2,2,1.000,6,16,22,0,1,0,3,12,16
Chris Duhon,2006,PG,23,CHI,6,0,131,9,25,.360,7,16,.438,2,9,.222,.500,5,6,.833,1,15,16,13,2,0,5,13,30
Tim Duncan*,2006,PF,29,SAS,13,13,493,121,211,.573,0,2,.000,121,209,.579,.573,94,131,.718,33,104,137,43,11,25,34,50,336
Francisco Elson,2006,C,29,DEN,5,2,75,3,5,.600,0,0,,3,5,.600,.600,0,0,,5,6,11,2,4,0,3,13,6
Maurice Evans,2006,SG,27,DET,16,0,101,16,30,.533,7,11,.636,9,19,.474,.650,14,16,.875,6,8,14,3,1,1,2,10,53
Reggie Evans,2006,PF,25,DEN,5,0,69,3,7,.429,0,2,.000,3,5,.600,.429,13,18,.722,8,15,23,0,2,1,6,11,19
Daniel Ewing,2006,SG,22,LAC,6,0,5,1,1,1.000,0,0,,1,1,1.000,1.000,0,0,,0,0,0,0,0,0,0,0,2
Michael Finley,2006,SG,32,SAS,13,4,411,50,105,.476,18,47,.383,32,58,.552,.562,18,20,.900,1,48,49,18,8,3,9,19,136
T.J. Ford,2006,PG,22,MIL,5,5,162,25,51,.490,2,5,.400,23,46,.500,.510,11,12,.917,3,17,20,32,3,0,16,20,63
Jeff Foster,2006,C,29,IND,4,4,80,4,11,.364,0,0,,4,11,.364,.364,3,4,.750,11,13,24,3,4,1,0,9,11
Dan Gadzuric,2006,C,27,MIL,4,0,16,8,9,.889,0,0,,8,9,.889,.889,1,2,.500,2,2,4,0,0,1,0,3,17
Francisco GarcÃ­a,2006,SF,24,SAC,6,0,41,5,11,.455,1,4,.250,4,7,.571,.500,2,2,1.000,0,2,2,1,2,2,0,5,13
Pau Gasol,2006,PF,25,MEM,4,4,158,29,67,.433,0,1,.000,29,66,.439,.433,23,30,.767,4,23,27,12,2,5,11,11,81
Devean George,2006,SF,28,LAL,7,0,121,13,34,.382,9,21,.429,4,13,.308,.515,2,5,.400,2,14,16,4,4,1,0,13,37
Eddie Gill,2006,PG,27,IND,2,0,1,0,0,,0,0,,0,0,,,0,0,,0,0,0,0,0,0,1,0,0
Manu GinÃ³bili*,2006,SG,28,SAS,13,11,426,76,157,.484,14,42,.333,62,115,.539,.529,73,87,.839,9,50,59,39,19,7,33,43,239
Drew Gooden,2006,PF,24,CLE,13,13,282,45,85,.529,0,0,,45,85,.529,.529,17,18,.944,31,67,98,8,3,2,18,40,107
Ben Gordon,2006,SG,22,CHI,6,6,245,43,106,.406,15,41,.366,28,65,.431,.476,25,37,.676,5,15,20,18,6,0,17,12,126
Danny Granger,2006,SF,22,IND,6,3,162,18,34,.529,9,16,.563,9,18,.500,.662,4,4,1.000,7,24,31,10,4,7,7,20,49
Brian Grant,2006,C,33,PHO,5,0,12,1,3,.333,0,0,,1,3,.333,.333,0,2,.000,2,0,2,0,0,0,0,7,2
Adrian Griffin,2006,SG,31,DAL,20,8,349,32,59,.542,0,0,,32,59,.542,.542,7,8,.875,28,43,71,24,15,2,11,42,71
Richard Hamilton,2006,SG,27,DET,18,18,690,128,310,.413,14,40,.350,114,270,.422,.435,97,114,.851,16,36,52,48,17,5,39,59,367
Othella Harrington,2006,C,32,CHI,3,0,15,0,3,.000,0,0,,0,3,.000,.000,0,0,,0,2,2,0,1,0,0,2,0
Devin Harris,2006,PG,22,DAL,23,15,558,82,171,.480,0,8,.000,82,163,.503,.480,52,74,.703,15,24,39,50,18,3,42,69,216
David Harrison,2006,C,23,IND,6,0,31,3,9,.333,0,0,,3,9,.333,.333,7,12,.583,1,4,5,0,1,1,4,11,13
Jason Hart,2006,PG,27,SAC,5,0,52,4,13,.308,0,0,,4,13,.308,.308,2,2,1.000,1,1,2,3,3,0,4,8,10
Udonis Haslem,2006,PF,25,MIA,22,22,650,74,150,.493,0,1,.000,74,149,.497,.493,41,60,.683,49,113,162,17,13,7,31,79,189
Brendan Haywood,2006,C,26,WAS,6,6,155,15,22,.682,0,0,,15,22,.682,.682,13,25,.520,7,12,19,5,2,11,7,22,43
Alan Henderson,2006,C,33,CLE,2,0,9,0,2,.000,0,0,,0,2,.000,.000,0,0,,1,1,2,0,0,0,0,1,0
Kirk Hinrich,2006,PG,25,CHI,6,6,234,39,94,.415,9,26,.346,30,68,.441,.463,36,42,.857,0,20,20,46,8,2,24,22,123
Robert Horry,2006,PF,35,SAS,13,5,224,15,37,.405,6,17,.353,9,20,.450,.486,19,26,.731,19,29,48,11,5,9,10,31,55
Eddie House,2006,PG,27,PHO,14,0,130,19,52,.365,3,14,.214,16,38,.421,.394,3,4,.750,0,9,9,6,1,2,5,10,44
Josh Howard,2006,SF,25,DAL,23,23,824,140,309,.453,24,65,.369,116,244,.475,.492,80,99,.808,41,130,171,32,23,14,52,85,384
Larry Hughes,2006,SG,27,CLE,9,8,336,36,113,.319,5,18,.278,31,95,.326,.341,23,31,.742,9,18,27,36,20,1,16,34,100
Lindsey Hunter,2006,PG,35,DET,18,0,217,26,78,.333,14,44,.318,12,34,.353,.423,10,10,1.000,8,11,19,29,15,1,14,41,76
Zydrunas Ilgauskas,2006,C,30,CLE,13,13,354,54,119,.454,0,0,,54,119,.454,.454,27,36,.750,33,49,82,10,5,27,24,46,135
D.J. Mbenga,2006,C,25,DAL,7,0,25,1,3,.333,0,0,,1,3,.333,.333,2,2,1.000,1,7,8,0,0,1,3,9,4
Bobby Jackson,2006,PG,32,MEM,4,0,100,12,29,.414,4,11,.364,8,18,.444,.483,5,7,.714,0,8,8,5,1,0,14,7,33
Jermaine Jackson,2006,PG,29,MIL,2,0,4,0,2,.000,0,0,,0,2,.000,.000,0,0,,0,0,0,2,0,0,0,1,0
Jim Jackson,2006,SF,35,LAL,3,0,21,2,6,.333,0,1,.000,2,5,.400,.333,0,0,,2,1,3,2,1,1,2,4,4
Stephen Jackson,2006,SG,27,IND,6,6,227,30,82,.366,6,26,.231,24,56,.429,.402,14,18,.778,5,22,27,20,4,1,15,23,80
LeBron James,2006,SF,21,CLE,13,13,604,146,307,.476,21,63,.333,125,244,.512,.510,87,118,.737,22,83,105,76,18,9,65,44,400
Antawn Jamison,2006,SF,29,WAS,6,6,253,42,99,.424,10,32,.313,32,67,.478,.475,21,27,.778,9,34,43,18,6,2,11,23,115
Å arÅ«nas JasikeviÄius,2006,PG,29,IND,6,0,66,7,19,.368,2,9,.222,5,10,.500,.421,1,2,.500,1,5,6,6,0,1,5,7,17
Richard Jefferson,2006,SF,25,NJN,11,11,437,90,165,.545,12,29,.414,78,136,.574,.582,52,63,.825,7,38,45,45,10,4,30,32,244
Jared Jeffries,2006,PF,24,WAS,6,6,215,17,43,.395,1,7,.143,16,36,.444,.407,13,17,.765,20,17,37,9,1,7,11,19,48
Anthony Johnson,2006,PG,31,IND,6,6,242,45,87,.517,8,20,.400,37,67,.552,.563,22,33,.667,8,22,30,31,6,0,14,17,120
DerMarr Johnson,2006,SG,25,DEN,3,0,34,3,13,.231,1,10,.100,2,3,.667,.269,0,0,,2,8,10,2,0,1,1,1,7
Ervin Johnson,2006,C,38,MIL,3,0,11,0,1,.000,0,0,,0,1,.000,.000,2,2,1.000,0,4,4,0,1,0,1,1,2
Dahntay Jones,2006,SF,25,MEM,4,0,46,5,7,.714,0,0,,5,7,.714,.714,7,10,.700,1,6,7,0,1,0,2,7,17
Damon Jones,2006,PG,29,CLE,13,0,181,8,26,.308,5,18,.278,3,8,.375,.404,3,4,.750,2,14,16,12,2,0,3,17,24
Eddie Jones,2006,SG,34,MEM,4,3,119,14,29,.483,3,7,.429,11,22,.500,.534,10,15,.667,3,8,11,10,3,1,1,10,41
Fred Jones,2006,SG,26,IND,6,1,167,15,36,.417,6,16,.375,9,20,.450,.500,11,12,.917,2,18,20,15,6,1,8,13,47
James Jones,2006,SF,25,PHO,20,6,353,28,82,.341,8,26,.308,20,56,.357,.390,22,26,.846,16,56,72,5,5,18,9,25,86
Chris Kaman,2006,C,23,LAC,11,10,324,51,86,.593,0,0,,51,86,.593,.593,16,21,.762,21,67,88,10,5,9,33,38,118
Jason Kapono,2006,SF,24,MIA,1,0,2,0,0,,0,0,,0,0,,,0,0,,0,0,0,0,0,0,0,0,0
Jason Kidd*,2006,PG,32,NJN,11,11,450,49,132,.371,15,50,.300,34,82,.415,.428,19,23,.826,22,62,84,106,17,2,24,31,132
Linas Kleiza,2006,PF,21,DEN,3,0,14,3,8,.375,0,1,.000,3,7,.429,.375,0,0,,1,3,4,2,0,0,0,3,6
Nenad KrstiÄ,2006,PF,22,NJN,11,11,366,65,129,.504,0,0,,65,129,.504,.504,32,45,.711,25,50,75,8,5,10,22,46,162
Toni KukoÄ*,2006,PF,37,MIL,3,0,53,8,14,.571,5,8,.625,3,6,.500,.750,1,2,.500,0,5,5,9,1,0,3,8,22
Shaun Livingston,2006,PG,20,LAC,12,0,332,36,76,.474,1,1,1.000,35,75,.467,.480,17,21,.810,16,40,56,57,7,6,23,31,90
Corey Maggette,2006,SF,26,LAC,12,2,292,57,122,.467,8,24,.333,49,98,.500,.500,61,67,.910,7,80,87,17,7,5,26,39,183
Jamaal Magloire,2006,C,27,MIL,5,5,135,18,38,.474,0,0,,18,38,.474,.474,9,15,.600,11,29,40,5,2,6,6,14,45
Shawn Marion,2006,PF,27,PHO,20,20,849,163,333,.489,22,70,.314,141,263,.536,.523,59,67,.881,57,176,233,31,37,23,22,65,407
Donyell Marshall,2006,PF,32,CLE,13,0,345,45,104,.433,18,46,.391,27,58,.466,.519,15,17,.882,24,49,73,8,7,9,13,24,123
Kenyon Martin,2006,PF,28,DEN,2,0,35,4,13,.308,0,0,,4,13,.308,.308,1,2,.500,6,3,9,1,4,2,3,5,9
Kevin Martin,2006,SG,22,SAC,6,1,197,22,54,.407,6,19,.316,16,35,.457,.463,29,29,1.000,10,20,30,3,3,2,2,11,79
Walter McCarty,2006,SF,31,LAC,8,0,10,1,4,.250,0,1,.000,1,3,.333,.250,0,0,,0,1,1,0,0,0,0,2,2
Antonio McDyess,2006,PF,31,DET,18,0,370,57,102,.559,0,1,.000,57,101,.564,.559,23,42,.548,39,70,109,11,8,13,14,54,137
Aaron McKie,2006,PG,33,LAL,1,0,8,0,0,,0,0,,0,0,,,0,0,,0,0,0,0,0,0,0,0,0
Andre Miller,2006,PG,29,DEN,5,5,182,34,77,.442,0,0,,34,77,.442,.442,14,17,.824,8,14,22,36,5,1,16,12,82
Brad Miller,2006,C,29,SAC,6,6,166,21,52,.404,1,7,.143,20,45,.444,.413,12,13,.923,3,15,18,15,7,5,7,20,55
Mike Miller,2006,SG,25,MEM,4,1,107,12,30,.400,1,8,.125,11,22,.500,.417,9,9,1.000,1,14,15,7,2,2,8,11,34
Cuttino Mobley,2006,SG,30,LAC,12,12,473,61,143,.427,11,30,.367,50,113,.442,.465,26,29,.897,10,47,57,24,8,3,23,28,159
Nazr Mohammed,2006,C,28,SAS,8,3,94,11,15,.733,1,1,1.000,10,14,.714,.767,13,18,.722,15,16,31,1,3,6,8,17,36
Alonzo Mourning*,2006,C,35,MIA,21,0,226,26,37,.703,0,0,,26,37,.703,.703,28,42,.667,17,44,61,3,5,24,17,49,80
Lamond Murray,2006,SF,32,NJN,11,0,197,21,54,.389,12,34,.353,9,20,.450,.500,9,11,.818,9,29,38,2,3,0,3,25,63
Ronald Murray,2006,SG,26,CLE,13,5,399,37,112,.330,5,24,.208,32,88,.364,.353,26,32,.813,11,31,42,21,9,2,9,27,105
BoÅ¡tjan Nachbar,2006,SF,25,NJN,1,0,1,0,0,,0,0,,0,0,,,0,0,,0,0,0,0,0,0,0,0,0
Eduardo NÃ¡jera,2006,PF,29,DEN,4,3,89,3,14,.214,0,0,,3,14,.214,.214,2,4,.500,4,11,15,2,3,0,4,13,8
Steve Nash*,2006,PG,31,PHO,20,20,798,146,291,.502,32,87,.368,114,204,.559,.557,83,91,.912,9,64,73,204,8,5,67,38,407
Rasho NesteroviÄ,2006,C,29,SAS,9,1,114,11,19,.579,1,1,1.000,10,18,.556,.605,2,2,1.000,7,23,30,1,2,5,2,17,25
Ira Newble,2006,SG,31,CLE,5,0,11,3,3,1.000,1,1,1.000,2,2,1.000,1.167,0,0,,1,1,2,0,1,0,1,1,7
AndrÃ©s Nocioni,2006,PF,26,CHI,6,6,230,47,84,.560,10,21,.476,37,63,.587,.619,30,35,.857,5,48,53,9,5,2,14,21,134
Dirk Nowitzki,2006,PF,27,DAL,23,23,983,196,419,.468,23,67,.343,173,352,.491,.495,205,229,.895,47,221,268,67,25,14,49,64,620
Jermaine O'Neal,2006,PF,27,IND,6,6,216,44,84,.524,0,2,.000,44,82,.537,.524,38,53,.717,9,36,45,10,3,14,26,28,126
Shaquille O'Neal*,2006,C,33,MIA,23,23,759,178,291,.612,0,0,,178,291,.612,.612,68,182,.374,75,150,225,39,11,34,85,84,424
Fabricio Oberto,2006,C,30,SAS,7,0,34,3,9,.333,0,0,,3,9,.333,.333,1,4,.250,3,3,6,1,1,3,2,7,7
Lamar Odom,2006,PF,26,LAL,7,7,314,49,99,.495,6,30,.200,43,69,.623,.525,30,45,.667,15,62,77,34,3,8,23,23,134
Scott Padgett,2006,PF,29,NJN,3,0,9,1,2,.500,0,1,.000,1,1,1.000,.500,1,2,.500,2,1,3,0,1,0,0,3,3
Jannero Pargo,2006,PG,26,CHI,5,0,19,5,12,.417,3,5,.600,2,7,.286,.542,4,5,.800,1,5,6,3,0,0,3,0,17
Smush Parker,2006,PG,24,LAL,7,7,258,24,72,.333,4,26,.154,20,46,.435,.361,10,10,1.000,9,12,21,11,15,1,12,24,62
Tony Parker,2006,PG,23,SAS,13,13,475,104,226,.460,2,9,.222,102,217,.470,.465,64,79,.810,8,39,47,50,13,1,40,31,274
Ruben Patterson,2006,SG,30,DEN,4,1,58,9,17,.529,0,0,,9,17,.529,.529,2,5,.400,5,1,6,3,1,0,3,6,20
Sasha PavloviÄ,2006,SG,22,CLE,3,0,4,0,2,.000,0,1,.000,0,1,.000,.000,0,0,,0,1,1,0,0,0,0,0,0
Gary Payton*,2006,PG,37,MIA,23,0,560,49,116,.422,17,58,.293,32,58,.552,.496,18,25,.720,6,34,40,36,23,3,18,55,133
Eric Piatkowski,2006,SG,35,CHI,6,0,28,3,6,.500,2,5,.400,1,1,1.000,.667,2,2,1.000,1,4,5,1,0,1,0,1,10
Zoran PlaniniÄ,2006,PG,23,NJN,3,0,6,0,1,.000,0,0,,0,1,.000,.000,0,2,.000,0,1,1,2,1,0,1,1,0
Scot Pollard,2006,C,30,IND,4,0,15,0,1,.000,0,0,,0,1,.000,.000,0,0,,1,4,5,0,1,0,1,5,0
James Posey,2006,SF,29,MIA,22,1,607,49,114,.430,35,83,.422,14,31,.452,.583,27,37,.730,15,110,125,20,17,2,11,70,160
Vitaly Potapenko,2006,C,30,SAC,4,0,9,2,4,.500,0,0,,2,4,.500,.500,0,0,,1,0,1,0,1,0,0,2,4
Josh Powell,2006,PF,23,DAL,6,0,25,0,4,.000,0,0,,0,4,.000,.000,0,0,,2,0,2,1,0,0,1,5,0
Ronnie Price,2006,PG,22,SAC,4,0,9,0,3,.000,0,0,,0,3,.000,.000,0,0,,0,0,0,1,0,0,0,1,0
Tayshaun Prince,2006,SF,25,DET,18,18,745,106,231,.459,21,46,.457,85,185,.459,.504,63,76,.829,43,59,102,54,12,15,31,23,296
Vladimir RadmanoviÄ,2006,PF,25,LAC,12,2,246,31,66,.470,19,41,.463,12,25,.480,.614,16,23,.696,9,39,48,13,7,6,8,35,97
Å½eljko RebraÄa,2006,C,33,LAC,3,0,22,1,3,.333,0,0,,1,3,.333,.333,0,0,,1,3,4,0,0,1,2,6,2
Michael Redd,2006,SG,26,MIL,5,5,185,44,84,.524,7,15,.467,37,69,.536,.565,41,46,.891,16,11,27,8,4,0,10,11,136
Clifford Robinson,2006,PF,39,NJN,8,0,198,13,39,.333,6,19,.316,7,20,.350,.410,4,5,.800,2,24,26,5,9,3,10,28,36
Quinton Ross,2006,SF,24,LAC,12,10,294,39,73,.534,0,0,,39,73,.534,.534,14,16,.875,8,24,32,9,7,8,9,36,92
Michael Ruffin,2006,C,29,WAS,6,0,70,1,2,.500,0,0,,1,2,.500,.500,0,2,.000,6,10,16,4,1,2,2,10,2
Luke Schenscher,2006,C,23,CHI,3,0,17,2,2,1.000,0,0,,2,2,1.000,1.000,3,4,.750,3,4,7,0,0,0,1,2,7
Wayne Simien,2006,PF,22,MIA,2,0,7,0,3,.000,0,0,,0,3,.000,.000,0,0,,1,0,1,0,0,0,1,1,0
Bobby Simmons,2006,SF,25,MIL,5,5,159,14,42,.333,5,12,.417,9,30,.300,.393,0,0,,4,14,18,10,9,1,6,11,33
James Singleton,2006,SF,24,LAC,7,0,12,1,3,.333,0,2,.000,1,1,1.000,.333,0,0,,0,3,3,2,0,0,0,3,2
Joe Smith,2006,PF,30,MIL,5,0,106,16,33,.485,0,0,,16,33,.485,.485,6,9,.667,6,21,27,3,2,2,1,16,38
Eric Snow,2006,PG,32,CLE,13,13,408,32,76,.421,0,1,.000,32,75,.427,.421,22,29,.759,10,33,43,36,11,3,21,36,86
Jerry Stackhouse,2006,SG,31,DAL,22,1,711,111,276,.402,22,65,.338,89,211,.422,.442,58,74,.784,20,42,62,56,12,6,37,43,302
Peja StojakoviÄ,2006,SF,28,IND,2,2,51,8,18,.444,0,3,.000,8,15,.533,.444,6,7,.857,0,9,9,4,1,1,1,4,22
Mike Sweetney,2006,C,23,CHI,6,6,120,14,34,.412,0,0,,14,34,.412,.412,15,19,.789,16,17,33,7,3,6,7,24,43
Donell Taylor,2006,SG,23,WAS,1,0,3,0,1,.000,0,1,.000,0,0,,.000,0,0,,0,0,0,1,1,0,0,0,0
Jason Terry,2006,PG,28,DAL,22,22,844,163,369,.442,31,101,.307,132,268,.493,.484,59,71,.831,12,52,64,83,26,1,44,55,416
Billy Thomas,2006,SG,30,WAS,3,0,14,0,7,.000,0,4,.000,0,3,.000,.000,2,4,.500,0,1,1,0,0,0,0,3,2
Etan Thomas,2006,C,27,WAS,3,0,18,2,5,.400,0,0,,2,5,.400,.400,2,4,.500,2,4,6,0,2,2,0,3,6
John Thomas,2006,C,30,NJN,8,0,56,3,6,.500,0,0,,3,6,.500,.500,1,2,.500,4,6,10,2,3,1,5,15,7
Kenny Thomas,2006,PF,28,SAC,6,6,148,13,24,.542,0,0,,13,24,.542,.542,9,13,.692,12,15,27,8,5,0,9,22,35
Kurt Thomas,2006,C,33,PHO,1,0,6,0,0,,0,0,,0,0,,,1,2,.500,0,1,1,0,0,0,0,2,1
Tim Thomas,2006,PF,28,PHO,20,14,636,108,220,.491,48,108,.444,60,112,.536,.600,38,49,.776,16,110,126,25,18,8,22,90,302
Jamaal Tinsley,2006,PG,27,IND,1,0,7,1,3,.333,0,2,.000,1,1,1.000,.333,0,0,,0,0,0,1,1,0,1,1,2
Jake Tsakalidis,2006,C,26,MEM,4,3,59,6,10,.600,0,0,,6,10,.600,.600,1,2,.500,4,7,11,2,1,1,7,13,13
Nikoloz Tskitishvili,2006,SF,22,PHO,4,0,8,0,3,.000,0,1,.000,0,2,.000,.000,1,2,.500,0,1,1,2,0,0,1,1,1
Ronny Turiaf,2006,C,23,LAL,3,0,25,3,5,.600,0,0,,3,5,.600,.600,5,6,.833,4,3,7,0,0,1,2,5,11
Beno Udrih,2006,PG,23,SAS,7,0,47,10,30,.333,1,6,.167,9,24,.375,.350,4,5,.800,1,3,4,8,0,0,3,8,25
Nick Van Exel,2006,PG,34,SAS,12,0,133,7,32,.219,3,10,.300,4,22,.182,.266,9,9,1.000,1,11,12,17,3,2,5,14,26
Keith Van Horn,2006,SF,30,DAL,14,3,172,20,59,.339,8,28,.286,12,31,.387,.407,3,3,1.000,8,24,32,2,0,4,6,24,51
Anderson VarejÃ£o,2006,C,23,CLE,13,0,238,31,50,.620,0,0,,31,50,.620,.620,26,37,.703,18,40,58,3,9,2,6,50,88
Jacque Vaughn,2006,SG,30,NJN,11,0,159,12,33,.364,0,1,.000,12,32,.375,.364,4,7,.571,3,8,11,12,2,0,4,23,28
Sasha VujaÄiÄ,2006,PG,21,LAL,7,0,129,11,26,.423,9,15,.600,2,11,.182,.596,11,11,1.000,3,14,17,6,4,0,3,14,42
Dwyane Wade,2006,SG,24,MIA,23,23,959,219,441,.497,14,37,.378,205,404,.507,.512,202,250,.808,28,107,135,132,51,26,90,71,654
Antoine Walker,2006,PF,29,MIA,23,23,862,114,283,.403,48,148,.324,66,135,.489,.488,31,54,.574,16,113,129,56,23,8,47,69,307
Ben Wallace*,2006,C,31,DET,18,18,642,33,71,.465,0,1,.000,33,70,.471,.465,18,66,.273,60,129,189,31,24,22,15,41,84
Rasheed Wallace,2006,PF,31,DET,18,18,628,96,223,.430,32,79,.405,64,144,.444,.502,29,55,.527,17,97,114,32,10,15,25,65,253
Luke Walton,2006,SF,25,LAL,7,7,235,38,83,.458,4,11,.364,34,72,.472,.482,5,5,1.000,10,35,45,12,7,1,11,16,85
Hakim Warrick,2006,PF,23,MEM,3,1,43,4,16,.250,0,1,.000,4,15,.267,.250,12,14,.857,1,6,7,0,1,0,4,7,20
Bonzi Wells,2006,SG,29,SAC,6,6,249,53,87,.609,5,8,.625,48,79,.608,.638,28,43,.651,25,47,72,8,5,2,18,25,139
JiÅÃ­ Welsch,2006,SF,26,MIL,4,0,15,2,4,.500,0,0,,2,4,.500,.500,3,4,.750,0,3,3,2,1,0,0,1,7
Jason Williams,2006,PG,30,MIA,23,23,686,75,185,.405,26,95,.274,49,90,.544,.476,38,45,.844,3,43,46,90,15,0,36,42,214
Mo Williams,2006,PG,23,MIL,5,0,75,17,34,.500,2,11,.182,15,23,.652,.529,0,0,,0,3,3,10,1,0,6,12,36
Corliss Williamson,2006,SF,32,SAC,3,0,11,2,5,.400,0,0,,2,5,.400,.400,3,3,1.000,0,1,1,0,0,0,0,3,7
Metta World Peace,2006,SF,26,SAC,5,5,198,31,81,.383,9,27,.333,22,54,.407,.438,16,23,.696,8,17,25,15,8,4,5,15,87
Antoine Wright,2006,SG,21,NJN,5,0,10,1,4,.250,0,0,,1,4,.250,.250,2,3,.667,0,0,0,0,0,0,0,0,4
Lorenzen Wright,2006,C,30,MEM,4,0,86,11,18,.611,0,0,,11,18,.611,.611,7,10,.700,11,9,20,3,0,4,5,9,29
Hassan Adams,2007,SG,22,NJN,6,0,9,1,2,.500,0,0,,1,2,.500,.500,0,0,,0,1,1,0,0,0,0,3,2
Maurice Ager,2007,SG,22,DAL,3,0,24,5,9,.556,2,3,.667,3,6,.500,.667,3,6,.500,1,2,3,0,0,0,0,3,15
Malik Allen,2007,PF,28,CHI,5,0,34,2,12,.167,0,0,,2,12,.167,.167,0,0,,4,3,7,1,1,1,3,7,4
Rafer Alston,2007,PG,30,HOU,7,7,309,25,74,.338,16,50,.320,9,24,.375,.446,10,13,.769,6,42,48,35,13,3,17,23,76
Carmelo Anthony,2007,SF,22,DEN,5,5,210,47,98,.480,9,18,.500,38,80,.475,.526,31,39,.795,18,25,43,6,5,0,19,12,134
Rafael AraÃºjo,2007,C,26,UTA,5,0,28,3,8,.375,0,0,,3,8,.375,.375,5,12,.417,3,8,11,1,1,0,0,8,11
Trevor Ariza,2007,SG,21,ORL,4,0,47,5,16,.313,0,0,,5,16,.313,.313,1,4,.250,5,4,9,5,1,0,4,9,11
Carlos Arroyo,2007,PG,27,ORL,3,0,40,5,14,.357,0,2,.000,5,12,.417,.357,2,2,1.000,2,3,5,6,1,0,1,4,12
Kelenna Azubuike,2007,SG,23,GSW,6,0,15,1,3,.333,0,1,.000,1,2,.500,.333,2,2,1.000,1,3,4,0,1,0,0,1,4
Marcus Banks,2007,PG,25,PHO,2,0,7,0,2,.000,0,1,.000,0,1,.000,.000,2,2,1.000,0,0,0,1,0,0,0,0,2
Leandro Barbosa,2007,SG,24,PHO,11,1,349,64,158,.405,18,59,.305,46,99,.465,.462,28,39,.718,7,31,38,24,12,2,22,30,174
J.J. Barea,2007,PG,22,DAL,2,0,4,0,0,,0,0,,0,0,,,0,2,.000,0,0,0,0,0,0,0,0,0
Andrea Bargnani,2007,PF,21,TOR,6,3,181,22,46,.478,7,17,.412,15,29,.517,.554,15,19,.789,3,21,24,6,5,3,7,16,66
Matt Barnes,2007,PF,26,GSW,11,3,330,45,100,.450,19,45,.422,26,55,.473,.545,13,18,.722,26,37,63,26,16,4,20,44,122
Brent Barry,2007,SG,35,SAS,19,0,225,21,60,.350,15,49,.306,6,11,.545,.475,2,2,1.000,4,21,25,21,4,2,11,17,59
Tony Battie,2007,PF,30,ORL,4,4,87,7,18,.389,0,0,,7,18,.389,.389,1,4,.250,3,13,16,1,0,0,0,12,15
Shane Battier,2007,SF,28,HOU,7,7,272,23,51,.451,19,43,.442,4,8,.500,.637,7,8,.875,3,15,18,15,12,7,8,20,72
Raja Bell,2007,SG,30,PHO,11,11,438,40,87,.460,20,45,.444,20,42,.476,.575,12,14,.857,6,27,33,20,10,2,15,40,112
Andris BiedriÅÅ¡,2007,C,20,GSW,11,8,267,27,37,.730,0,0,,27,37,.730,.730,16,30,.533,19,50,69,5,8,17,9,29,70
Chauncey Billups,2007,PG,30,DET,16,16,649,84,193,.435,35,90,.389,49,103,.476,.526,94,113,.832,7,46,53,91,19,2,46,39,297
Steve Blake,2007,PG,26,DEN,5,5,180,14,31,.452,8,16,.500,6,15,.400,.581,0,0,,1,11,12,23,3,0,10,8,36
Andray Blatche,2007,PF,20,WAS,2,0,25,4,6,.667,0,0,,4,6,.667,.667,1,1,1.000,3,4,7,0,0,0,1,2,9
Matt Bonner,2007,PF,26,SAS,9,0,25,2,7,.286,1,4,.250,1,3,.333,.357,2,2,1.000,2,1,3,0,2,0,3,6,7
Josh Boone,2007,PF,22,NJN,12,0,118,12,24,.500,0,0,,12,24,.500,.500,12,24,.500,7,12,19,3,1,3,3,16,36
Calvin Booth,2007,C,30,WAS,1,0,18,2,3,.667,0,0,,2,3,.667,.667,0,0,,2,2,4,1,1,0,1,3,4
Carlos Boozer,2007,PF,25,UTA,17,17,654,162,302,.536,0,0,,162,302,.536,.536,76,103,.738,54,153,207,50,17,5,51,52,400
Chris Bosh*,2007,C,22,TOR,6,6,222,36,91,.396,1,5,.200,35,86,.407,.401,32,38,.842,7,47,54,15,5,11,12,19,105
Bruce Bowen,2007,SF,35,SAS,20,20,689,47,119,.395,33,74,.446,14,45,.311,.534,3,6,.500,12,69,81,26,28,4,14,54,130
Ronnie Brewer,2007,SG,21,UTA,8,0,41,6,10,.600,0,0,,6,10,.600,.600,7,13,.538,2,4,6,2,1,0,2,3,19
Dee Brown,2007,PG,22,UTA,8,0,52,6,17,.353,0,6,.000,6,11,.545,.353,1,4,.250,1,2,3,9,0,0,4,1,13
Kwame Brown,2007,C,24,LAL,5,5,133,19,36,.528,0,0,,19,36,.528,.528,5,9,.556,13,15,28,1,1,4,9,16,43
P.J. Brown,2007,PF,37,CHI,10,10,228,33,67,.493,0,0,,33,67,.493,.493,17,23,.739,17,30,47,12,8,2,8,29,83
Shannon Brown,2007,SG,21,CLE,1,0,0,0,0,,0,0,,0,0,,,0,0,,0,0,0,0,0,0,0,0,0
Kobe Bryant*,2007,SG,28,LAL,5,5,215,60,130,.462,10,28,.357,50,102,.490,.500,34,37,.919,1,25,26,22,5,2,22,10,164
Greg Buckner,2007,SG,30,DAL,6,0,44,0,7,.000,0,4,.000,0,3,.000,.000,1,2,.500,2,4,6,2,2,1,2,7,1
Pat Burke,2007,C,33,PHO,3,0,7,1,2,.500,0,0,,1,2,.500,.500,0,0,,0,1,1,0,0,1,0,3,2
Andrew Bynum,2007,C,19,LAL,5,0,55,8,15,.533,0,0,,8,15,.533,.533,4,10,.400,8,15,23,0,0,2,2,7,20
JosÃ© CalderÃ³n,2007,PG,25,TOR,6,1,146,35,69,.507,3,12,.250,32,57,.561,.529,5,6,.833,2,8,10,32,5,0,15,12,78
Marcus Camby,2007,C,32,DEN,5,5,184,17,45,.378,0,0,,17,45,.378,.378,4,6,.667,12,62,74,10,4,16,10,14,38
Anthony Carter,2007,PG,31,DEN,1,0,14,4,4,1.000,0,0,,4,4,1.000,1.000,0,1,.000,0,1,1,2,0,0,1,2,8
Vince Carter,2007,SG,30,NJN,12,12,487,93,235,.396,21,54,.389,72,181,.398,.440,61,88,.693,17,65,82,64,11,7,38,35,268
Jarron Collins,2007,C,28,UTA,13,0,110,3,9,.333,0,0,,3,9,.333,.333,9,17,.529,8,12,20,5,4,0,1,21,15
Jason Collins,2007,PF,28,NJN,12,12,329,12,21,.571,0,0,,12,21,.571,.571,4,11,.364,16,24,40,2,7,3,16,45,28
Brian Cook,2007,PF,26,LAL,5,0,51,6,18,.333,3,7,.429,3,11,.273,.417,3,3,1.000,2,4,6,0,0,1,2,13,18
Austin Croshere,2007,PF,31,DAL,3,0,34,4,12,.333,3,4,.750,1,8,.125,.458,4,4,1.000,3,3,6,0,0,0,2,5,15
Erick Dampier,2007,C,31,DAL,5,2,38,2,3,.667,0,0,,2,3,.667,.667,1,2,.500,9,8,17,1,0,0,4,9,5
Antonio Daniels,2007,SG,31,WAS,4,4,176,17,38,.447,1,5,.200,16,33,.485,.461,18,21,.857,2,16,18,47,5,1,7,4,53
Baron Davis,2007,PG,27,GSW,11,11,445,98,191,.513,25,67,.373,73,124,.589,.579,57,74,.770,11,39,50,72,32,7,32,46,278
Dale Davis,2007,C,37,DET,8,0,51,3,8,.375,0,0,,3,8,.375,.375,2,4,.500,5,7,12,1,2,2,2,14,8
Carlos Delfino,2007,SG,24,DET,16,0,135,15,37,.405,3,16,.188,12,21,.571,.446,4,6,.667,6,15,21,8,5,1,7,13,37
Luol Deng,2007,SF,21,CHI,10,10,410,88,168,.524,0,1,.000,88,167,.527,.524,46,57,.807,30,57,87,24,10,7,23,22,222
Boris Diaw,2007,PF,24,PHO,10,0,235,28,59,.475,0,6,.000,28,53,.528,.475,10,15,.667,13,19,32,30,7,2,17,18,66
Yakhouba Diawara,2007,SG,24,DEN,1,0,1,0,0,,0,0,,0,0,,,0,0,,0,0,0,0,0,0,0,0,0
DeSagana Diop,2007,C,25,DAL,6,3,140,9,15,.600,0,0,,9,15,.600,.600,3,7,.429,16,25,41,2,3,10,4,21,21
Juan Dixon,2007,SG,28,TOR,6,0,63,8,21,.381,2,8,.250,6,13,.462,.429,0,0,,0,4,4,3,7,0,10,6,18
Michael Doleac,2007,C,29,MIA,1,0,1,0,0,,0,0,,0,0,,,0,0,,0,0,0,0,0,0,0,0,0
Keyon Dooling,2007,SG,26,ORL,4,0,65,12,25,.480,1,3,.333,11,22,.500,.500,4,6,.667,1,6,7,5,2,1,2,7,29
Chris Duhon,2007,PG,24,CHI,9,0,172,9,31,.290,6,19,.316,3,12,.250,.387,8,10,.800,3,13,16,21,3,1,7,12,32
Tim Duncan*,2007,C,30,SAS,20,20,736,174,334,.521,0,0,,174,334,.521,.521,96,149,.644,73,156,229,65,13,62,59,59,444
Monta Ellis,2007,SG,21,GSW,11,6,238,32,82,.390,1,9,.111,31,73,.425,.396,23,28,.821,8,17,25,10,10,2,20,23,88
Francisco Elson,2007,C,30,SAS,20,8,230,26,44,.591,0,1,.000,26,43,.605,.591,14,20,.700,22,40,62,2,8,6,19,41,66
Maurice Evans,2007,SG,28,LAL,5,0,82,10,26,.385,5,13,.385,5,13,.385,.481,0,0,,3,5,8,3,2,0,0,4,25
Jordan Farmar,2007,PG,20,LAL,5,5,114,12,28,.429,2,10,.200,10,18,.556,.464,6,7,.857,1,13,14,8,6,1,5,9,32
Michael Finley,2007,SF,33,SAS,20,20,538,73,178,.410,44,105,.419,29,73,.397,.534,35,39,.897,8,50,58,22,11,4,13,28,225
Derek Fisher,2007,SG,32,UTA,16,14,445,49,121,.405,12,32,.375,37,89,.416,.455,42,45,.933,4,21,25,42,16,2,19,51,152
T.J. Ford,2007,PG,23,TOR,6,5,136,37,76,.487,5,10,.500,32,66,.485,.520,17,21,.810,5,5,10,24,7,2,14,7,96
Adonal Foyle,2007,C,31,GSW,3,0,6,1,1,1.000,0,0,,1,1,1.000,1.000,0,0,,0,2,2,0,0,0,0,0,2
Devean George,2007,SF,29,DAL,6,1,109,5,25,.200,3,12,.250,2,13,.154,.260,8,10,.800,4,14,18,4,6,2,7,12,21
Daniel Gibson,2007,PG,20,CLE,20,2,402,50,116,.431,27,66,.409,23,50,.460,.547,38,43,.884,9,23,32,21,12,4,9,34,165
Manu GinÃ³bili*,2007,SG,29,SAS,20,0,602,99,247,.401,38,99,.384,61,148,.412,.478,97,116,.836,16,93,109,74,33,4,42,61,333
Gordan GiriÄek,2007,SG,29,UTA,17,3,307,38,91,.418,14,26,.538,24,65,.369,.495,14,16,.875,4,24,28,17,3,2,22,37,104
Drew Gooden,2007,PF,25,CLE,20,20,605,99,201,.493,0,2,.000,99,199,.497,.493,30,39,.769,49,111,160,20,10,9,27,62,228
Ben Gordon,2007,SG,23,CHI,10,10,395,61,147,.415,24,55,.436,37,92,.402,.497,58,63,.921,9,29,38,38,9,1,34,34,204
Joey Graham,2007,SF,24,TOR,6,3,109,6,21,.286,0,1,.000,6,20,.300,.286,4,5,.800,1,19,20,2,4,0,6,12,16
Adrian Griffin,2007,SF,32,CHI,4,0,9,0,6,.000,0,0,,0,6,.000,.000,0,0,,1,0,1,0,1,0,0,1,0
Richard Hamilton,2007,SG,28,DET,16,16,638,108,252,.429,8,20,.400,100,232,.431,.444,77,89,.865,32,37,69,60,14,2,31,60,301
Matt Harpring,2007,SF,30,UTA,17,0,433,62,136,.456,0,4,.000,62,132,.470,.456,34,47,.723,33,49,82,23,7,3,22,41,158
Al Harrington,2007,PF,26,GSW,11,5,262,39,98,.398,15,38,.395,24,60,.400,.474,19,30,.633,17,34,51,6,5,7,10,40,112
Devin Harris,2007,PG,23,DAL,6,6,163,31,63,.492,3,10,.300,28,53,.528,.516,14,19,.737,1,11,12,30,6,1,9,23,79
Udonis Haslem,2007,PF,26,MIA,4,4,103,12,25,.480,0,0,,12,25,.480,.480,6,8,.750,4,17,21,4,1,2,2,14,30
Chuck Hayes,2007,PF,23,HOU,7,7,197,12,17,.706,0,1,.000,12,16,.750,.706,2,5,.400,14,31,45,3,9,3,7,22,26
Jarvis Hayes,2007,SF,25,WAS,4,4,139,15,46,.326,7,19,.368,8,27,.296,.402,6,7,.857,4,10,14,4,2,1,0,12,43
Brendan Haywood,2007,C,27,WAS,3,0,34,5,7,.714,0,0,,5,7,.714,.714,3,4,.750,3,2,5,1,1,0,1,7,13
Luther Head,2007,SG,24,HOU,7,0,141,11,36,.306,6,23,.261,5,13,.385,.389,4,8,.500,2,17,19,8,3,2,7,16,32
NenÃª,2007,C,24,DEN,5,5,179,31,53,.585,0,0,,31,53,.585,.585,14,18,.778,22,17,39,12,3,3,13,21,76
Grant Hill*,2007,SG,34,ORL,4,4,143,19,38,.500,0,0,,19,38,.500,.500,22,33,.667,2,20,22,15,2,1,10,8,60
Kirk Hinrich,2007,PG,26,CHI,10,10,362,44,117,.376,13,43,.302,31,74,.419,.432,20,26,.769,4,38,42,75,9,3,23,37,121
Robert Horry,2007,PF,36,SAS,18,0,361,25,60,.417,13,37,.351,12,23,.522,.525,14,17,.824,16,54,70,29,11,24,14,30,77
Eddie House,2007,SG,28,NJN,4,0,18,2,8,.250,1,6,.167,1,2,.500,.313,0,0,,0,2,2,1,1,0,2,2,5
Dwight Howard,2007,C,21,ORL,4,4,167,23,42,.548,0,0,,23,42,.548,.548,15,33,.455,16,43,59,7,2,4,17,13,61
Josh Howard,2007,SF,26,DAL,6,6,248,51,99,.515,7,18,.389,44,81,.543,.551,19,27,.704,15,44,59,17,13,5,12,22,128
Juwan Howard,2007,PF,33,HOU,7,0,157,14,35,.400,0,0,,14,35,.400,.400,7,11,.636,10,21,31,7,5,0,4,10,35
Larry Hughes,2007,SG,28,CLE,18,18,639,69,199,.347,19,54,.352,50,145,.345,.394,47,63,.746,9,62,71,44,25,8,42,35,204
Kris Humphries,2007,PF,21,TOR,6,0,69,3,9,.333,0,0,,3,9,.333,.333,3,8,.375,7,10,17,1,1,2,3,11,9
Lindsey Hunter,2007,PG,36,DET,13,0,133,7,31,.226,4,18,.222,3,13,.231,.290,5,5,1.000,2,8,10,16,6,1,10,22,23
Zydrunas Ilgauskas,2007,C,31,CLE,20,20,649,97,197,.492,0,0,,97,197,.492,.492,57,68,.838,66,127,193,17,9,16,32,60,251
Allen Iverson*,2007,SG,31,DEN,5,5,223,42,114,.368,5,17,.294,37,97,.381,.390,25,31,.806,0,3,3,29,7,0,15,11,114
Luke Jackson,2007,SF,25,TOR,3,0,11,0,0,,0,0,,0,0,,,6,6,1.000,1,4,5,1,1,0,1,3,6
Stephen Jackson,2007,SF,28,GSW,11,11,454,61,161,.379,26,72,.361,35,89,.393,.460,71,87,.816,6,34,40,40,22,8,41,39,219
LeBron James,2007,SF,22,CLE,20,20,893,166,399,.416,21,75,.280,145,324,.448,.442,148,196,.755,26,135,161,159,34,10,66,40,501
Antawn Jamison,2007,PF,30,WAS,4,4,173,49,103,.476,9,26,.346,40,77,.519,.519,21,28,.750,13,26,39,5,2,4,7,13,128
Å arÅ«nas JasikeviÄius,2007,PG,30,GSW,4,0,6,0,1,.000,0,0,,0,1,.000,.000,1,2,.500,0,0,0,2,0,0,0,1,1
Richard Jefferson,2007,SF,26,NJN,12,12,489,81,168,.482,13,40,.325,68,128,.531,.521,61,66,.924,4,63,67,27,9,5,27,24,236
Damon Jones,2007,PG,30,CLE,11,0,139,8,26,.308,7,22,.318,1,4,.250,.442,3,3,1.000,1,8,9,11,0,0,0,10,26
Eddie Jones,2007,SG,35,MIA,3,2,66,2,9,.222,1,6,.167,1,3,.333,.278,5,6,.833,1,5,6,5,1,1,1,7,10
James Jones,2007,SF,26,PHO,11,6,171,19,36,.528,8,18,.444,11,18,.611,.639,9,11,.818,3,12,15,3,2,2,4,11,55
Jason Kapono,2007,SF,25,MIA,4,1,77,8,17,.471,2,4,.500,6,13,.462,.529,2,2,1.000,0,5,5,2,2,0,1,9,20
Jason Kidd*,2007,PG,33,NJN,12,12,484,64,148,.432,34,81,.420,30,67,.448,.547,13,25,.520,23,108,131,131,22,5,41,31,175
Andrei Kirilenko,2007,SF,25,UTA,17,17,527,55,123,.447,3,9,.333,52,114,.456,.459,51,65,.785,28,61,89,44,15,40,35,52,164
Linas Kleiza,2007,PF,22,DEN,5,0,66,3,13,.231,1,6,.167,2,7,.286,.269,1,2,.500,0,8,8,2,0,0,0,6,8
John Lucas III,2007,PG,24,HOU,2,0,8,0,1,.000,0,1,.000,0,0,,.000,0,0,,0,0,0,0,1,0,2,0,0
Shawn Marion,2007,SF,28,PHO,11,11,455,76,152,.500,12,34,.353,64,118,.542,.539,22,33,.667,27,87,114,13,16,19,12,27,186
Donyell Marshall,2007,PF,33,CLE,19,0,204,23,69,.333,14,45,.311,9,24,.375,.435,7,11,.636,12,29,41,5,3,4,5,30,67
Darrick Martin,2007,PG,35,TOR,2,0,8,0,2,.000,0,2,.000,0,0,,.000,2,2,1.000,0,1,1,2,0,0,0,0,2
Roger Mason,2007,SG,26,WAS,4,0,56,7,16,.438,5,10,.500,2,6,.333,.594,5,6,.833,0,2,2,1,1,0,3,10,24
Jason Maxiell,2007,C,23,DET,14,0,146,22,33,.667,0,1,.000,22,32,.688,.667,12,23,.522,11,22,33,2,4,9,7,21,56
Antonio McDyess,2007,PF,32,DET,16,0,354,37,106,.349,0,2,.000,37,104,.356,.349,19,26,.731,41,72,113,18,11,15,17,55,93
Tracy McGrady*,2007,SG,27,HOU,7,7,280,63,160,.394,9,36,.250,54,124,.435,.422,42,57,.737,5,36,41,51,5,6,21,12,177
C.J. Miles,2007,SG,19,UTA,1,0,3,0,0,,0,0,,0,0,,,1,2,.500,0,0,0,0,0,0,0,0,1
Darko MiliÄiÄ,2007,PF,21,ORL,4,0,115,20,34,.588,0,0,,20,34,.588,.588,9,17,.529,10,8,18,4,1,4,2,9,49
Paul Millsap,2007,PF,21,UTA,17,0,263,42,80,.525,0,1,.000,42,79,.532,.525,16,24,.667,38,37,75,8,11,9,13,39,100
Yao Ming*,2007,C,26,HOU,7,7,260,55,125,.440,0,0,,55,125,.440,.440,66,75,.880,23,49,72,6,1,5,33,27,176
Nazr Mohammed,2007,C,29,DET,2,0,6,1,2,.500,0,0,,1,2,.500,.500,3,3,1.000,1,2,3,0,0,0,0,1,5
Mikki Moore,2007,C,31,NJN,12,12,399,56,100,.560,0,0,,56,100,.560,.560,23,29,.793,23,44,67,14,10,7,20,47,135
Alonzo Mourning*,2007,C,36,MIA,4,0,55,10,11,.909,0,0,,10,11,.909,.909,5,13,.385,1,7,8,1,0,3,1,6,25
Ronald Murray,2007,SG,27,DET,12,0,136,11,31,.355,0,2,.000,11,29,.379,.355,8,11,.727,2,7,9,14,4,1,8,12,30
Dikembe Mutombo*,2007,C,40,HOU,7,0,40,3,3,1.000,0,0,,3,3,1.000,1.000,3,3,1.000,5,6,11,1,0,3,0,5,9
BoÅ¡tjan Nachbar,2007,SF,26,NJN,12,0,281,40,95,.421,18,48,.375,22,47,.468,.516,21,22,.955,5,30,35,18,7,1,18,30,119
Eduardo NÃ¡jera,2007,PF,30,DEN,5,0,96,4,17,.235,0,3,.000,4,14,.286,.235,1,2,.500,11,17,28,2,2,1,2,10,9
Steve Nash*,2007,PG,32,PHO,11,11,413,74,160,.463,19,39,.487,55,121,.455,.522,41,46,.891,4,31,35,146,4,1,48,21,208
Jameer Nelson,2007,PG,24,ORL,4,4,129,21,50,.420,5,14,.357,16,36,.444,.470,10,11,.909,4,8,12,13,3,0,9,19,57
Rasho NesteroviÄ,2007,C,30,TOR,5,4,71,7,15,.467,0,0,,7,15,.467,.467,3,3,1.000,10,13,23,3,0,2,4,4,17
Ira Newble,2007,SF,32,CLE,6,0,10,0,2,.000,0,2,.000,0,0,,.000,0,0,,0,1,1,1,0,0,0,3,0
AndrÃ©s Nocioni,2007,PF,27,CHI,10,0,197,31,86,.360,13,39,.333,18,47,.383,.436,13,18,.722,3,32,35,8,2,5,13,25,88
Dirk Nowitzki,2007,PF,28,DAL,6,6,239,36,94,.383,4,19,.211,32,75,.427,.404,42,50,.840,25,43,68,14,11,8,14,20,118
Shaquille O'Neal*,2007,C,34,MIA,4,4,121,33,59,.559,0,0,,33,59,.559,.559,9,27,.333,16,18,34,5,1,6,14,15,75
Fabricio Oberto,2007,C,31,SAS,20,12,415,50,80,.625,0,1,.000,50,79,.633,.625,12,21,.571,41,57,98,14,6,4,10,54,112
Lamar Odom,2007,PF,27,LAL,5,5,192,41,85,.482,3,11,.273,38,74,.514,.500,12,24,.500,20,45,65,11,2,6,10,17,97
Mehmet Okur,2007,C,27,UTA,17,17,585,71,183,.388,25,79,.316,46,104,.442,.456,33,42,.786,37,95,132,30,24,16,24,65,200
Anthony Parker,2007,SG,31,TOR,6,6,240,26,62,.419,8,20,.400,18,42,.429,.484,31,39,.795,3,29,32,6,9,2,7,18,91
Smush Parker,2007,PG,25,LAL,5,0,59,2,13,.154,1,6,.167,1,7,.143,.192,4,4,1.000,4,3,7,3,3,1,3,8,9
Tony Parker,2007,PG,24,SAS,20,20,751,168,350,.480,7,21,.333,161,329,.489,.490,72,106,.679,14,53,67,115,22,0,66,34,415
Sasha PavloviÄ,2007,SG,23,CLE,20,20,616,72,189,.381,20,58,.345,52,131,.397,.434,19,36,.528,13,38,51,32,19,5,36,64,183
Gary Payton*,2007,PG,38,MIA,2,0,32,0,3,.000,0,1,.000,0,2,.000,.000,0,0,,0,4,4,3,0,0,4,3,0
Morris Peterson,2007,SF,29,TOR,6,2,183,15,29,.517,6,12,.500,9,17,.529,.621,5,6,.833,5,22,27,2,2,2,6,20,41
Eric Piatkowski,2007,SG,36,PHO,1,0,3,1,1,1.000,0,0,,1,1,1.000,1.000,0,0,,0,0,0,0,0,0,0,0,2
MickaÃ«l PiÃ©trus,2007,SF,24,GSW,11,0,209,17,49,.347,7,27,.259,10,22,.455,.418,25,36,.694,13,29,42,6,5,9,7,32,66
Scot Pollard,2007,C,31,CLE,3,0,3,0,0,,0,0,,0,0,,,0,0,,0,0,0,0,0,0,0,1,0
James Posey,2007,SF,30,MIA,4,1,139,10,26,.385,6,19,.316,4,7,.571,.500,5,5,1.000,1,30,31,6,8,5,5,18,31
Josh Powell,2007,PF,24,GSW,4,0,6,0,0,,0,0,,0,0,,,1,2,.500,1,0,1,0,0,1,0,0,1
Tayshaun Prince,2007,SF,26,DET,16,16,665,83,200,.415,18,44,.409,65,156,.417,.460,41,54,.759,27,76,103,60,15,5,30,30,225
J.J. Redick,2007,PG,22,ORL,1,0,11,1,2,.500,1,1,1.000,0,1,.000,.750,0,0,,0,0,0,2,0,0,1,2,3
Jason Richardson,2007,SG,26,GSW,11,11,428,81,170,.476,29,82,.354,52,88,.591,.562,19,27,.704,24,50,74,22,14,5,24,38,210
Bernard Robinson,2007,SF,26,NJN,1,0,6,0,1,.000,0,0,,0,1,.000,.000,0,0,,0,1,1,2,1,0,1,2,0
Clifford Robinson,2007,C,40,NJN,4,0,20,1,6,.167,1,2,.500,0,4,.000,.250,0,0,,0,0,0,0,1,0,1,1,3
Jalen Rose,2007,SF,34,PHO,1,0,9,1,4,.250,0,1,.000,1,3,.333,.250,0,0,,0,1,1,2,0,0,0,2,2
Michael Ruffin,2007,PF,30,WAS,4,0,28,1,3,.333,0,1,.000,1,2,.500,.333,0,0,,5,4,9,0,3,0,0,2,2
Thabo Sefolosha,2007,SG,22,CHI,9,0,99,10,26,.385,3,8,.375,7,18,.389,.442,7,12,.583,4,13,17,7,2,0,7,11,30
J.R. Smith,2007,SG,21,DEN,4,0,47,6,22,.273,0,12,.000,6,10,.600,.273,6,6,1.000,1,8,9,2,4,1,3,6,18
Eric Snow,2007,PG,33,CLE,19,0,244,12,38,.316,0,3,.000,12,35,.343,.316,8,14,.571,7,21,28,29,11,2,8,22,32
Kirk Snyder,2007,SF,23,HOU,3,0,9,1,3,.333,0,2,.000,1,1,1.000,.333,0,0,,0,1,1,0,0,0,1,0,2
Darius Songaila,2007,PF,28,WAS,4,0,90,20,41,.488,0,2,.000,20,39,.513,.488,3,3,1.000,5,8,13,4,3,0,4,17,43
Vassilis Spanoulis,2007,SG,24,HOU,1,0,3,1,2,.500,0,0,,1,2,.500,.500,2,2,1.000,0,1,1,1,0,0,0,0,4
Jerry Stackhouse,2007,SF,32,DAL,6,0,169,23,66,.348,11,31,.355,12,35,.343,.432,29,33,.879,5,17,22,15,4,1,18,9,86
DeShawn Stevenson,2007,SG,25,WAS,4,4,122,9,46,.196,3,19,.158,6,27,.222,.228,3,7,.429,2,8,10,7,2,3,3,4,24
Amar'e Stoudemire,2007,C,24,PHO,10,10,343,91,174,.523,1,3,.333,90,171,.526,.526,70,91,.769,30,91,121,6,13,19,19,39,253
Mike Sweetney,2007,C,24,CHI,1,0,3,1,2,.500,0,0,,1,2,.500,.500,0,2,.000,0,0,0,0,0,0,0,1,2
Donell Taylor,2007,SG,24,WAS,2,0,17,1,6,.167,0,0,,1,6,.167,.167,1,1,1.000,0,3,3,4,0,0,2,2,3
Jason Terry,2007,SG,29,DAL,6,6,229,39,92,.424,9,32,.281,30,60,.500,.473,15,18,.833,3,11,14,22,5,2,17,12,102
Etan Thomas,2007,C,28,WAS,4,4,84,7,17,.412,0,0,,7,17,.412,.412,6,9,.667,2,20,22,1,2,3,6,9,20
Kurt Thomas,2007,C,34,PHO,11,5,212,34,65,.523,0,0,,34,65,.523,.523,15,17,.882,11,43,54,12,6,9,9,25,83
Tyrus Thomas,2007,PF,20,CHI,10,0,122,16,41,.390,0,0,,16,41,.390,.390,19,30,.633,12,22,34,6,10,5,15,23,51
Jake Tsakalidis,2007,C,27,HOU,1,0,3,0,0,,0,0,,0,0,,,2,2,1.000,1,3,4,0,0,0,0,0,2
Ronny Turiaf,2007,C,24,LAL,4,0,48,5,14,.357,0,0,,5,14,.357,.357,7,10,.700,6,6,12,1,2,1,1,8,17
Hedo TÃ¼rkoÄlu,2007,SF,27,ORL,4,4,156,25,50,.500,3,9,.333,22,41,.537,.530,2,4,.500,2,11,13,14,5,4,10,14,55
Beno Udrih,2007,PG,24,SAS,8,0,20,0,6,.000,0,2,.000,0,4,.000,.000,2,2,1.000,1,0,1,1,0,0,3,2,2
Anderson VarejÃ£o,2007,C,24,CLE,20,0,447,46,90,.511,0,4,.000,46,86,.535,.511,27,48,.563,46,73,119,11,21,11,20,53,119
Jacque Vaughn,2007,PG,31,SAS,20,0,208,20,50,.400,0,0,,20,50,.400,.400,3,6,.500,1,8,9,28,4,0,11,24,43
Sasha VujaÄiÄ,2007,SG,22,LAL,4,0,43,5,9,.556,1,4,.250,4,5,.800,.611,0,0,,2,2,4,3,1,0,3,4,11
Dwyane Wade,2007,SG,25,MIA,4,4,162,36,84,.429,0,5,.000,36,79,.456,.429,22,32,.688,7,12,19,25,5,2,23,13,94
Antoine Walker,2007,PF,30,MIA,4,0,92,15,37,.405,8,16,.500,7,21,.333,.514,9,11,.818,2,7,9,6,2,1,4,11,47
Ben Wallace*,2007,C,32,CHI,10,10,369,30,53,.566,0,1,.000,30,52,.577,.566,27,54,.500,29,66,95,14,15,17,10,19,87
Rasheed Wallace,2007,C,32,DET,16,16,573,86,197,.437,25,72,.347,61,125,.488,.500,32,38,.842,19,104,123,28,19,28,19,64,229
Luke Walton,2007,SF,26,LAL,5,5,128,14,36,.389,5,12,.417,9,24,.375,.458,3,4,.750,9,12,21,13,7,1,15,13,36
Chris Webber*,2007,PF,33,DET,16,16,404,66,126,.524,0,1,.000,66,125,.528,.524,26,49,.531,36,64,100,24,14,9,25,51,158
Deron Williams,2007,PG,22,UTA,17,17,657,122,270,.452,19,57,.333,103,213,.484,.487,64,81,.790,9,64,73,146,26,4,68,49,327
Jason Williams,2007,PG,31,MIA,4,4,112,7,28,.250,5,17,.294,2,11,.182,.339,4,5,.800,0,8,8,14,5,1,3,5,23
Marcus Williams,2007,PG,21,NJN,12,0,78,12,36,.333,1,13,.077,11,23,.478,.347,4,5,.800,3,7,10,13,1,0,12,4,29
Shammond Williams,2007,PG,31,LAL,4,0,80,8,20,.400,2,8,.250,6,12,.500,.450,0,0,,2,1,3,7,0,1,2,6,18
Antoine Wright,2007,SG,22,NJN,12,0,163,17,36,.472,3,6,.500,14,30,.467,.514,9,10,.900,5,18,23,1,5,4,5,14,46
Dorell Wright,2007,SF,21,MIA,1,0,1,0,0,,0,0,,0,0,,,0,0,,0,0,0,0,0,0,0,0,0
Arron Afflalo,2008,SG,22,DET,12,0,84,7,18,.389,0,2,.000,7,16,.438,.389,0,0,,0,5,5,6,4,0,1,5,14
Malik Allen,2008,PF,29,DAL,3,0,18,0,1,.000,0,0,,0,1,.000,.000,0,0,,0,0,0,0,0,0,0,4,0
Ray Allen*,2008,SG,32,BOS,26,26,987,133,311,.428,55,139,.396,78,172,.453,.516,84,92,.913,25,73,98,71,24,8,38,63,405
Tony Allen,2008,SG,26,BOS,15,0,65,9,16,.563,0,1,.000,9,15,.600,.563,2,5,.400,1,2,3,3,2,0,1,5,20
Rafer Alston,2008,PG,31,HOU,4,4,126,21,48,.438,11,25,.440,10,23,.435,.552,4,5,.800,2,4,6,18,4,0,6,7,57
Lou Amundson,2008,PF,25,PHI,2,0,10,2,4,.500,0,0,,2,4,.500,.500,1,2,.500,5,2,7,0,0,0,0,2,5
Carmelo Anthony,2008,SF,23,DEN,4,4,146,32,88,.364,2,8,.250,30,80,.375,.375,24,29,.828,19,19,38,8,2,1,12,17,90
Gilbert Arenas,2008,PG,26,WAS,4,2,94,14,36,.389,5,12,.417,9,24,.375,.458,10,12,.833,0,7,7,11,2,0,8,13,43
Trevor Ariza,2008,SF,22,LAL,8,0,45,7,12,.583,1,4,.250,6,8,.750,.625,2,4,.500,3,8,11,1,1,1,1,7,17
Hilton Armstrong,2008,C,23,NOH,8,0,72,8,13,.615,0,0,,8,13,.615,.615,5,10,.500,9,11,20,0,0,6,4,12,21
Carlos Arroyo,2008,PG,28,ORL,4,0,30,2,4,.500,0,1,.000,2,3,.667,.500,2,2,1.000,0,2,2,4,0,0,3,4,6
Chucky Atkins,2008,SG,33,DEN,1,0,3,0,1,.000,0,1,.000,0,0,,.000,0,0,,0,1,1,0,0,0,0,0,0
James Augustine,2008,PF,23,ORL,1,0,2,1,1,1.000,0,0,,1,1,1.000,1.000,0,0,,0,1,1,0,0,0,0,0,2
Leandro Barbosa,2008,SG,25,PHO,5,1,143,19,55,.345,4,18,.222,15,37,.405,.382,10,11,.909,2,18,20,9,3,0,4,10,52
J.J. Barea,2008,PG,23,DAL,1,0,5,3,4,.750,2,2,1.000,1,2,.500,1.000,0,0,,0,0,0,1,0,0,0,1,8
Andrea Bargnani,2008,PF,22,TOR,5,5,104,13,39,.333,4,16,.250,9,23,.391,.385,2,2,1.000,1,6,7,2,4,3,2,15,32
Brent Barry,2008,SF,36,SAS,16,0,227,26,53,.491,19,41,.463,7,12,.583,.670,12,15,.800,2,16,18,17,6,2,9,22,83
Brandon Bass,2008,C,22,DAL,5,0,133,17,36,.472,0,1,.000,17,35,.486,.472,24,25,.960,20,14,34,2,3,3,3,12,58
Maceo Baston,2008,PF,32,TOR,1,0,1,0,0,,0,0,,0,0,,,0,0,,0,0,0,0,1,0,0,0,0
Shane Battier,2008,SF,29,HOU,6,6,246,20,45,.444,12,25,.480,8,20,.400,.578,8,11,.727,7,16,23,3,6,5,8,19,60
Raja Bell,2008,SG,31,PHO,5,5,215,21,37,.568,13,20,.650,8,17,.471,.743,13,16,.813,6,22,28,11,2,1,5,19,68
Mike Bibby,2008,PG,29,ATL,7,7,252,22,65,.338,7,24,.292,15,41,.366,.392,21,32,.656,3,19,22,22,4,2,13,12,72
Chauncey Billups,2008,PG,31,DET,15,15,480,69,172,.401,24,64,.375,45,108,.417,.471,79,95,.832,6,38,44,83,12,1,20,32,241
Andray Blatche,2008,PF,21,WAS,6,0,89,9,21,.429,0,1,.000,9,20,.450,.429,4,12,.333,7,13,20,1,2,6,5,15,22
Keith Bogans,2008,SG,27,ORL,10,0,293,25,68,.368,15,45,.333,10,23,.435,.478,8,11,.727,4,38,42,11,4,0,7,26,73
Matt Bonner,2008,PF,27,SAS,2,0,9,2,3,.667,0,0,,2,3,.667,.667,0,0,,0,2,2,2,0,0,0,0,4
Carlos Boozer,2008,PF,26,UTA,12,12,441,76,183,.415,0,0,,76,183,.415,.415,40,56,.714,42,105,147,34,6,2,36,47,192
Chris Bosh*,2008,C,23,TOR,5,5,199,42,89,.472,1,7,.143,41,82,.500,.478,35,42,.833,20,25,45,18,8,2,13,19,120
Bruce Bowen,2008,SF,36,SAS,17,17,508,37,93,.398,22,54,.407,15,39,.385,.516,8,11,.727,2,31,33,23,11,6,9,41,104
Ryan Bowen,2008,SF,32,NOH,9,0,39,1,6,.167,0,1,.000,1,5,.200,.167,2,2,1.000,3,11,14,2,1,0,1,1,4
Ronnie Brewer,2008,SG,22,UTA,12,12,305,51,98,.520,1,6,.167,50,92,.543,.526,19,25,.760,17,21,38,19,12,4,4,29,122
Aaron Brooks,2008,PG,23,HOU,6,0,50,8,25,.320,0,10,.000,8,15,.533,.320,9,11,.818,0,6,6,3,0,0,3,11,25
Devin Brown,2008,SG,29,CLE,8,0,92,9,34,.265,5,17,.294,4,17,.235,.338,10,15,.667,8,11,19,9,2,0,9,10,33
P.J. Brown,2008,PF,38,BOS,25,0,341,26,56,.464,0,1,.000,26,55,.473,.464,21,25,.840,18,41,59,12,5,10,12,58,73
Kobe Bryant*,2008,SG,29,LAL,21,21,863,222,463,.479,32,106,.302,190,357,.532,.514,157,194,.809,18,101,119,117,35,8,70,59,633
Caron Butler,2008,SF,27,WAS,6,6,246,40,87,.460,5,21,.238,35,66,.530,.489,27,31,.871,10,24,34,23,11,1,16,19,112
JosÃ© CalderÃ³n,2008,PG,26,TOR,5,0,120,22,50,.440,10,21,.476,12,29,.414,.540,5,5,1.000,4,14,18,35,1,0,6,15,59
Marcus Camby,2008,C,33,DEN,4,4,124,5,21,.238,1,1,1.000,4,20,.200,.262,2,6,.333,11,42,53,12,4,12,10,10,13
Rodney Carney,2008,SF,23,PHI,6,0,84,12,31,.387,5,10,.500,7,21,.333,.468,1,2,.500,3,4,7,5,7,2,0,9,30
Anthony Carter,2008,PG,32,DEN,4,1,61,4,14,.286,0,5,.000,4,9,.444,.286,0,0,,2,8,10,14,1,1,3,6,8
Sam Cassell,2008,PG,38,BOS,21,0,264,37,111,.333,6,28,.214,31,83,.373,.360,14,17,.824,2,13,15,25,8,1,12,30,94
Tyson Chandler,2008,C,25,NOH,12,12,412,43,68,.632,0,0,,43,68,.632,.632,10,16,.625,45,78,123,5,5,20,10,43,96
Josh Childress,2008,SF,24,ATL,7,0,205,22,42,.524,0,2,.000,22,40,.550,.524,6,12,.500,15,25,40,11,1,5,2,7,50
Jarron Collins,2008,C,29,UTA,5,0,20,0,3,.000,0,0,,0,3,.000,.000,0,0,,3,3,6,1,1,1,0,2,0
Samuel Dalembert,2008,C,26,PHI,6,6,193,19,45,.422,0,0,,19,45,.422,.422,16,19,.842,20,37,57,3,2,10,10,17,54
Erick Dampier,2008,C,32,DAL,5,5,95,7,17,.412,0,0,,7,17,.412,.412,4,10,.400,12,9,21,0,1,3,3,15,18
Antonio Daniels,2008,PG,32,WAS,6,4,154,14,31,.452,1,4,.250,13,27,.481,.468,15,17,.882,1,13,14,18,2,2,7,6,44
Glen Davis,2008,C,22,BOS,17,0,137,14,34,.412,0,1,.000,14,33,.424,.412,11,18,.611,12,13,25,7,5,4,10,27,39
Carlos Delfino,2008,SG,25,TOR,5,0,121,15,37,.405,4,15,.267,11,22,.500,.459,9,10,.900,5,19,24,11,4,0,3,14,43
Boris Diaw,2008,PF,25,PHO,5,2,178,35,64,.547,0,7,.000,35,57,.614,.547,3,6,.500,7,21,28,23,3,4,11,22,73
Yakhouba Diawara,2008,SG,25,DEN,3,0,8,2,5,.400,0,2,.000,2,3,.667,.400,0,0,,0,1,1,0,0,0,0,0,4
Juan Dixon,2008,PG,29,DET,2,0,7,0,2,.000,0,0,,0,2,.000,.000,0,0,,0,0,0,0,0,0,0,0,0
Keyon Dooling,2008,PG,27,ORL,10,0,148,22,56,.393,9,23,.391,13,33,.394,.473,13,15,.867,2,8,10,7,6,1,6,22,66
Tim Duncan*,2008,C,31,SAS,17,17,666,135,301,.449,1,5,.200,134,296,.453,.450,72,115,.626,61,186,247,56,15,35,41,41,343
Melvin Ely,2008,C,29,NOH,7,0,59,4,15,.267,0,0,,4,15,.267,.267,7,10,.700,5,6,11,1,0,0,4,13,15
Maurice Evans,2008,SG,29,ORL,10,10,282,35,69,.507,15,36,.417,20,33,.606,.616,5,8,.625,7,18,25,7,8,1,9,12,90
Reggie Evans,2008,PF,27,PHI,6,0,148,13,26,.500,0,0,,13,26,.500,.500,15,24,.625,16,31,47,3,5,0,13,20,41
Jordan Farmar,2008,PG,21,LAL,21,0,360,44,115,.383,17,44,.386,27,71,.380,.457,14,16,.875,7,26,33,27,7,4,17,27,119
Michael Finley,2008,SG,34,SAS,17,11,391,43,107,.402,19,52,.365,24,55,.436,.491,9,9,1.000,1,32,33,17,5,3,6,25,114
Derek Fisher,2008,PG,33,LAL,21,21,663,66,146,.452,22,50,.440,44,96,.458,.527,61,73,.836,2,45,47,52,43,3,20,62,215
T.J. Ford,2008,PG,24,TOR,5,5,124,21,58,.362,1,8,.125,20,50,.400,.371,15,16,.938,3,19,22,33,5,0,10,10,58
Adonal Foyle,2008,C,32,ORL,3,0,11,1,3,.333,0,0,,1,3,.333,.333,0,0,,0,3,3,0,0,0,2,1,2
Kevin Garnett*,2008,PF,31,BOS,26,26,987,217,438,.495,2,8,.250,215,430,.500,.498,94,116,.810,72,202,274,87,35,29,55,74,530
Pat Garrity,2008,PF,31,ORL,2,0,6,0,2,.000,0,1,.000,0,1,.000,.000,1,2,.500,0,2,2,0,0,0,0,0,1
Pau Gasol,2008,C,27,LAL,21,21,836,141,266,.530,0,0,,141,266,.530,.530,72,104,.692,55,140,195,83,11,40,44,60,354
Devean George,2008,SF,30,DAL,5,0,62,11,28,.393,4,12,.333,7,16,.438,.464,3,5,.600,4,11,15,0,2,2,3,7,29
Daniel Gibson,2008,PG,21,CLE,11,0,284,35,78,.449,19,42,.452,16,36,.444,.571,10,14,.714,4,15,19,27,7,2,15,18,99
Manu GinÃ³bili*,2008,SG,30,SAS,17,6,559,98,232,.422,38,102,.373,60,130,.462,.504,69,77,.896,14,50,64,67,10,5,47,47,303
Gordan GiriÄek,2008,SG,30,PHO,5,0,80,6,18,.333,1,4,.250,5,14,.357,.361,4,4,1.000,0,7,7,2,2,0,3,3,17
Marcin Gortat,2008,C,23,ORL,8,0,48,5,6,.833,0,0,,5,6,.833,.833,0,0,,2,6,8,0,0,4,3,5,10
Joey Graham,2008,SF,25,TOR,2,0,2,0,2,.000,0,1,.000,0,1,.000,.000,0,0,,0,0,0,0,0,0,0,0,0
Willie Green,2008,SG,26,PHI,6,6,142,22,51,.431,1,5,.200,21,46,.457,.441,9,14,.643,2,6,8,12,5,4,9,19,54
Richard Hamilton,2008,SG,29,DET,17,17,656,134,285,.470,8,26,.308,126,259,.486,.484,92,101,.911,19,53,72,67,23,9,48,48,368
Matt Harpring,2008,SF,31,UTA,12,0,209,25,63,.397,1,3,.333,24,60,.400,.405,28,35,.800,17,17,34,8,7,4,11,35,79
Mike Harris,2008,PF,24,HOU,3,0,9,1,2,.500,0,0,,1,2,.500,.500,1,2,.500,1,1,2,0,0,0,0,0,3
Jason Hart,2008,PG,29,UTA,2,0,6,1,2,.500,0,1,.000,1,1,1.000,.500,0,0,,0,0,0,0,0,0,0,0,2
Chuck Hayes,2008,PF,24,HOU,6,0,108,7,11,.636,0,2,.000,7,9,.778,.636,0,0,,7,21,28,5,3,6,4,18,14
Jarvis Hayes,2008,SF,26,DET,11,0,61,9,30,.300,5,14,.357,4,16,.250,.383,0,0,,4,12,16,4,1,2,4,11,23
Brendan Haywood,2008,C,28,WAS,6,6,178,26,44,.591,0,0,,26,44,.591,.591,20,25,.800,13,27,40,5,4,9,6,25,72
Luther Head,2008,SG,25,HOU,5,0,44,1,14,.071,0,6,.000,1,8,.125,.071,2,2,1.000,1,1,2,4,2,1,4,3,4
Walter Herrmann,2008,PF,28,DET,4,0,27,1,4,.250,1,1,1.000,0,3,.000,.375,2,4,.500,1,0,1,0,0,0,0,4,5
NenÃª,2008,PF,25,DEN,3,0,30,5,9,.556,0,0,,5,9,.556,.556,3,3,1.000,3,4,7,1,2,1,2,8,13
Grant Hill*,2008,SF,35,PHO,3,2,68,5,11,.455,0,0,,5,11,.455,.455,1,1,1.000,3,13,16,3,2,1,0,3,11
Al Horford,2008,C,21,ATL,7,7,277,34,72,.472,0,0,,34,72,.472,.472,20,27,.741,22,51,73,25,3,7,15,26,88
Robert Horry,2008,PF,37,SAS,15,0,154,7,36,.194,5,22,.227,2,14,.143,.264,4,6,.667,11,21,32,8,5,5,2,34,23
Eddie House,2008,PG,29,BOS,21,0,165,17,56,.304,11,31,.355,6,25,.240,.402,7,8,.875,2,20,22,18,5,1,4,13,52
Dwight Howard,2008,C,22,ORL,10,10,421,72,124,.581,0,0,,72,124,.581,.581,45,83,.542,60,98,158,9,8,34,32,38,189
Josh Howard,2008,SF,27,DAL,5,5,171,21,72,.292,1,10,.100,20,62,.323,.299,20,25,.800,12,23,35,7,2,2,9,10,63
Juwan Howard,2008,PF,34,DAL,3,0,11,0,2,.000,0,0,,0,2,.000,.000,1,4,.250,0,0,0,1,0,0,0,2,1
Kris Humphries,2008,PF,22,TOR,3,0,2,0,0,,0,0,,0,0,,,0,0,,0,0,0,0,0,0,0,0,0
Lindsey Hunter,2008,PG,37,DET,11,0,115,8,21,.381,5,11,.455,3,10,.300,.500,0,0,,2,8,10,14,8,0,5,21,21
Steven Hunter,2008,C,26,DEN,2,0,5,0,1,.000,0,0,,0,1,.000,.000,0,0,,0,2,2,0,0,0,0,0,0
Andre Iguodala,2008,SF,24,PHI,6,6,234,23,69,.333,2,14,.143,21,55,.382,.348,31,43,.721,6,23,29,30,13,1,26,11,79
Zydrunas Ilgauskas,2008,C,32,CLE,13,13,393,67,140,.479,0,0,,67,140,.479,.479,36,44,.818,33,65,98,21,5,14,21,35,170
D.J. Mbenga,2008,C,27,LAL,7,0,30,5,8,.625,0,0,,5,8,.625,.625,0,0,,3,6,9,0,2,1,1,9,10
Allen Iverson*,2008,SG,32,DEN,4,4,158,36,83,.434,3,14,.214,33,69,.478,.452,23,33,.697,4,8,12,18,4,1,7,3,98
Bobby Jackson,2008,PG,34,HOU,6,2,138,20,70,.286,5,24,.208,15,46,.326,.321,7,11,.636,2,8,10,9,5,0,4,11,52
LeBron James,2008,SF,23,CLE,13,13,552,113,275,.411,18,70,.257,95,205,.463,.444,122,167,.731,16,86,102,99,23,17,54,33,366
Mike James,2008,PG,32,NOH,4,0,28,4,12,.333,2,5,.400,2,7,.286,.417,2,2,1.000,0,1,1,1,2,0,1,0,12
Antawn Jamison,2008,PF,31,WAS,6,6,237,39,96,.406,7,25,.280,32,71,.451,.443,16,28,.571,19,53,72,6,8,8,10,17,101
Amir Johnson,2008,PF,20,DET,8,0,43,9,12,.750,0,1,.000,9,11,.818,.750,3,6,.500,3,10,13,1,0,3,2,7,21
Joe Johnson,2008,SG,26,ATL,7,7,275,47,115,.409,16,36,.444,31,79,.392,.478,30,33,.909,9,18,27,28,2,0,16,16,140
Damon Jones,2008,SG,31,CLE,5,0,26,2,10,.200,2,7,.286,0,3,.000,.300,0,0,,0,0,0,1,0,0,1,1,6
Dwayne Jones,2008,PF,24,CLE,5,0,20,1,2,.500,0,0,,1,2,.500,.500,1,2,.500,2,4,6,0,0,1,1,4,3
Eddie Jones,2008,SG,36,DAL,3,0,22,2,6,.333,1,4,.250,1,2,.500,.417,1,1,1.000,0,3,3,1,1,0,1,3,6
Solomon Jones,2008,PF,23,ATL,7,0,29,2,10,.200,0,0,,2,10,.200,.200,0,2,.000,4,4,8,1,1,3,0,3,4
Jason Kapono,2008,SF,26,TOR,5,0,152,31,53,.585,13,24,.542,18,29,.621,.708,3,4,.750,2,11,13,4,2,0,2,9,78
Coby Karl,2008,SG,24,LAL,1,0,2,0,0,,0,0,,0,0,,,0,0,,0,0,0,1,0,0,0,1,0
Jason Kidd*,2008,PG,34,DAL,5,5,180,16,38,.421,6,13,.462,10,25,.400,.500,5,8,.625,8,24,32,34,7,2,9,12,43
Andrei Kirilenko,2008,SF,26,UTA,12,12,387,51,114,.447,5,22,.227,46,92,.500,.469,25,35,.714,15,26,41,30,18,20,18,46,132
Linas Kleiza,2008,SF,23,DEN,4,3,122,22,41,.537,3,14,.214,19,27,.704,.573,9,13,.692,8,18,26,3,1,0,5,11,56
Kyle Korver,2008,SG,26,UTA,12,0,259,30,73,.411,11,38,.289,19,35,.543,.486,23,25,.920,5,21,26,7,4,8,8,28,94
Carl Landry,2008,PF,24,HOU,6,0,106,11,26,.423,0,0,,11,26,.423,.423,12,16,.750,15,13,28,0,7,3,2,8,34
Acie Law,2008,PG,23,ATL,7,0,61,6,8,.750,0,0,,6,8,.750,.750,9,10,.900,0,2,2,8,2,0,8,5,21
Rashard Lewis,2008,PF,28,ORL,10,10,417,71,163,.436,21,68,.309,50,95,.526,.500,32,39,.821,24,48,72,34,11,5,23,18,195
Tyronn Lue,2008,PG,30,DAL,2,0,2,0,1,.000,0,0,,0,1,.000,.000,0,0,,1,0,1,1,0,0,0,0,0
Sean Marks,2008,C,32,PHO,1,0,3,0,0,,0,0,,0,0,,,0,0,,0,0,0,0,0,0,0,0,0
Kenyon Martin,2008,PF,30,DEN,4,4,118,15,34,.441,0,0,,15,34,.441,.441,5,8,.625,13,12,25,5,4,2,9,20,35
Roger Mason,2008,PG,27,WAS,6,0,129,19,47,.404,4,17,.235,15,30,.500,.447,6,8,.750,0,5,5,6,3,1,2,11,48
Jason Maxiell,2008,C,24,DET,17,6,371,40,64,.625,0,0,,40,64,.625,.625,15,32,.469,21,47,68,16,15,22,11,48,95
Antonio McDyess,2008,PF,33,DET,17,11,468,64,119,.538,0,0,,64,119,.538,.538,23,28,.821,48,78,126,16,10,8,20,65,151
Tracy McGrady*,2008,SG,28,HOU,6,6,247,62,146,.425,5,24,.208,57,122,.467,.442,33,53,.623,7,42,49,41,9,5,18,8,162
Dominic McGuire,2008,SG,22,WAS,3,0,15,0,0,,0,0,,0,0,,,1,2,.500,1,2,3,1,1,1,0,1,1
Chris Mihm,2008,C,28,LAL,1,0,3,0,1,.000,0,0,,0,1,.000,.000,0,0,,0,0,0,0,0,0,1,2,0
C.J. Miles,2008,SG,20,UTA,7,0,26,5,14,.357,2,8,.250,3,6,.500,.429,0,0,,1,4,5,0,2,0,2,4,12
Andre Miller,2008,PG,31,PHI,6,6,229,39,89,.438,0,3,.000,39,86,.453,.438,14,22,.636,7,12,19,20,5,0,14,12,92
Paul Millsap,2008,PF,22,UTA,12,0,210,32,62,.516,0,1,.000,32,61,.525,.516,13,25,.520,23,24,47,4,7,16,9,37,77
Jamario Moon,2008,SF,27,TOR,5,3,104,11,29,.379,4,11,.364,7,18,.389,.448,1,1,1.000,7,17,24,4,6,3,2,6,27
Dikembe Mutombo*,2008,C,41,HOU,6,6,123,8,13,.615,0,0,,8,13,.615,.615,7,11,.636,10,29,39,2,1,11,1,10,23
Eduardo NÃ¡jera,2008,PF,31,DEN,4,0,78,7,14,.500,2,5,.400,5,9,.556,.571,0,0,,5,8,13,6,3,1,5,15,16
Steve Nash*,2008,PG,33,PHO,5,5,183,32,70,.457,6,20,.300,26,50,.520,.500,11,12,.917,1,13,14,39,2,1,12,10,81
Jameer Nelson,2008,PG,25,ORL,10,10,333,57,113,.504,20,41,.488,37,72,.514,.593,28,37,.757,4,37,41,47,3,2,21,43,162
Rasho NesteroviÄ,2008,C,31,TOR,5,2,77,11,22,.500,0,0,,11,22,.500,.500,1,2,.500,3,10,13,3,1,2,5,14,23
Ira Newble,2008,SF,33,LAL,1,0,1,0,0,,0,0,,0,0,,,0,0,,0,0,0,0,0,0,0,0,0
Steve Novak,2008,SF,24,HOU,3,0,21,3,4,.750,2,3,.667,1,1,1.000,1.000,0,0,,1,1,2,0,0,1,0,2,8
Dirk Nowitzki,2008,PF,29,DAL,5,5,211,43,91,.473,6,18,.333,37,73,.507,.505,42,52,.808,10,50,60,20,1,7,10,13,134
Shaquille O'Neal*,2008,C,35,PHO,5,5,150,22,50,.440,0,0,,22,50,.440,.440,32,64,.500,13,33,46,5,5,13,9,21,76
Fabricio Oberto,2008,C,32,SAS,17,9,331,28,46,.609,0,0,,28,46,.609,.609,7,10,.700,15,56,71,20,6,5,14,48,63
Lamar Odom,2008,PF,28,LAL,21,21,786,107,218,.491,3,11,.273,104,207,.502,.498,84,127,.661,47,162,209,62,14,27,47,72,301
Mehmet Okur,2008,C,28,UTA,12,12,462,66,156,.423,19,51,.373,47,105,.448,.484,34,44,.773,34,107,141,23,8,8,19,37,185
Kevin Ollie,2008,SG,35,PHI,3,0,19,1,4,.250,0,0,,1,4,.250,.250,2,2,1.000,0,1,1,3,2,0,0,1,4
Zaza Pachulia,2008,C,23,ATL,7,0,105,7,25,.280,0,1,.000,7,24,.292,.280,15,21,.714,9,11,20,2,2,0,9,22,29
Jannero Pargo,2008,SG,28,NOH,12,0,265,45,116,.388,15,43,.349,30,73,.411,.453,17,24,.708,5,25,30,27,12,2,11,22,122
Anthony Parker,2008,SG,32,TOR,5,5,196,20,49,.408,5,17,.294,15,32,.469,.459,12,14,.857,4,26,30,10,4,2,4,12,57
Tony Parker,2008,PG,25,SAS,17,17,654,152,306,.497,7,20,.350,145,286,.507,.508,70,93,.753,10,53,63,103,16,1,50,37,381
Chris Paul,2008,PG,22,NOH,12,12,486,111,221,.502,5,21,.238,106,200,.530,.514,62,79,.785,16,43,59,135,28,2,22,43,289
Sasha PavloviÄ,2008,SG,24,CLE,8,0,111,10,26,.385,4,9,.444,6,17,.353,.462,4,6,.667,6,4,10,1,2,0,2,17,28
Oleksiy Pecherov,2008,C,22,WAS,3,0,8,0,1,.000,0,0,,0,1,.000,.000,2,2,1.000,0,1,1,0,1,1,0,0,2
Kendrick Perkins,2008,C,23,BOS,25,25,631,62,106,.585,0,1,.000,62,105,.590,.585,40,59,.678,52,101,153,13,15,32,31,91,164
Morris Peterson,2008,SG,30,NOH,12,12,277,33,68,.485,16,34,.471,17,34,.500,.603,4,6,.667,3,28,31,7,6,3,5,29,86
Eric Piatkowski,2008,SF,37,PHO,1,0,2,0,0,,0,0,,0,0,,,0,0,,0,0,0,0,0,0,0,1,0
Paul Pierce*,2008,SF,30,BOS,26,26,990,163,370,.441,43,119,.361,120,251,.478,.499,142,177,.802,21,108,129,119,28,8,82,90,511
James Posey,2008,PF,31,BOS,26,0,573,52,119,.437,35,88,.398,17,31,.548,.584,35,40,.875,12,81,93,28,26,8,14,61,174
Leon Powe,2008,C,24,BOS,23,1,270,36,73,.493,0,0,,36,73,.493,.493,44,66,.667,32,30,62,4,0,3,12,45,116
Ronnie Price,2008,PG,24,UTA,12,0,68,10,31,.323,3,14,.214,7,17,.412,.371,10,13,.769,1,3,4,11,6,2,6,6,33
Tayshaun Prince,2008,SF,27,DET,17,17,671,100,208,.481,8,25,.320,92,183,.503,.500,27,34,.794,32,62,94,55,14,8,32,30,235
Vladimir RadmanoviÄ,2008,SF,27,LAL,21,21,481,67,151,.444,29,78,.372,38,73,.521,.540,5,6,.833,23,57,80,31,13,1,21,56,168
Shavlik Randolph,2008,PF,24,PHI,2,0,4,0,1,.000,0,0,,0,1,.000,.000,3,4,.750,0,0,0,0,0,0,0,1,3
Theo Ratliff,2008,C,34,DET,12,0,131,6,12,.500,0,0,,6,12,.500,.500,4,8,.500,14,13,27,1,1,11,4,23,16
J.J. Redick,2008,SG,23,ORL,2,0,10,0,4,.000,0,3,.000,0,1,.000,.000,0,0,,0,1,1,0,0,0,0,1,0
Jeremy Richardson,2008,SF,23,ATL,3,0,6,1,4,.250,0,0,,1,4,.250,.250,0,0,,0,0,0,0,0,0,0,1,2
Rajon Rondo,2008,PG,21,BOS,26,26,831,107,263,.407,5,20,.250,102,243,.420,.416,47,68,.691,39,68,107,172,45,8,47,74,266
Luis Scola,2008,PF,27,HOU,6,6,220,30,67,.448,0,1,.000,30,66,.455,.448,24,35,.686,24,32,56,8,4,1,12,30,84
Brian Skinner,2008,C,31,PHO,4,0,21,2,4,.500,0,0,,2,4,.500,.500,4,8,.500,0,3,3,0,0,3,0,4,8
J.R. Smith,2008,SG,22,DEN,4,0,108,23,43,.535,7,22,.318,16,21,.762,.616,20,24,.833,1,6,7,7,4,0,5,12,73
Jason Smith,2008,PF,21,PHI,6,0,82,8,18,.444,0,1,.000,8,17,.471,.444,4,4,1.000,4,11,15,3,1,5,2,5,20
Joe Smith,2008,PF,32,CLE,13,0,263,36,74,.486,0,1,.000,36,73,.493,.486,14,22,.636,20,40,60,6,5,7,6,41,86
Josh Smith,2008,PF,22,ATL,7,7,237,35,88,.398,3,18,.167,32,70,.457,.415,37,44,.841,7,38,45,20,12,20,26,26,110
Darius Songaila,2008,C,29,WAS,5,0,77,8,19,.421,0,0,,8,19,.421,.421,13,15,.867,4,9,13,4,1,0,6,18,29
Jerry Stackhouse,2008,SG,33,DAL,5,2,102,12,38,.316,2,12,.167,10,26,.385,.342,5,5,1.000,4,12,16,6,1,0,7,9,31
DeShawn Stevenson,2008,SG,26,WAS,6,6,196,22,60,.367,14,36,.389,8,24,.333,.483,16,18,.889,2,11,13,18,6,0,9,11,74
Peja StojakoviÄ,2008,SF,30,NOH,12,12,455,58,133,.436,28,51,.549,30,82,.366,.541,25,27,.926,6,59,65,6,6,1,8,19,169
Damon Stoudamire,2008,PG,34,SAS,7,0,35,5,15,.333,1,4,.250,4,11,.364,.367,2,3,.667,2,5,7,2,1,0,1,0,13
Salim Stoudamire,2008,PG,25,ATL,3,0,28,4,9,.444,2,6,.333,2,3,.667,.556,2,2,1.000,0,1,1,0,1,0,3,2,12
Amar'e Stoudemire,2008,C,25,PHO,5,5,204,48,99,.485,1,4,.250,47,95,.495,.490,19,30,.633,15,30,45,2,7,12,14,19,116
D.J. Strawberry,2008,SG,22,PHO,1,0,5,0,4,.000,0,1,.000,0,3,.000,.000,0,0,,0,1,1,0,0,0,0,1,0
Rodney Stuckey,2008,PG,21,DET,17,2,380,43,116,.371,2,7,.286,41,109,.376,.379,51,58,.879,11,21,32,58,18,2,23,35,139
Wally Szczerbiak,2008,SF,30,CLE,13,13,374,47,125,.376,20,62,.323,27,63,.429,.456,26,28,.929,4,19,23,19,2,1,10,32,140
Jason Terry,2008,SG,30,DAL,5,3,180,26,60,.433,14,32,.438,12,28,.429,.550,13,15,.867,1,7,8,24,2,1,5,15,79
Billy Thomas,2008,SF,32,CLE,3,0,8,1,2,.500,1,2,.500,0,0,,.750,0,0,,0,1,1,1,1,0,0,0,3
Kurt Thomas,2008,PF,35,SAS,17,8,268,32,70,.457,0,0,,32,70,.457,.457,5,7,.714,26,58,84,6,2,6,13,46,69
Ronny Turiaf,2008,C,25,LAL,19,0,187,14,36,.389,0,0,,14,36,.389,.389,10,17,.588,6,21,27,5,2,18,9,41,38
Hedo TÃ¼rkoÄlu,2008,SF,28,ORL,10,10,399,63,141,.447,10,35,.286,53,106,.500,.482,39,46,.848,14,50,64,55,8,2,38,35,175
Ime Udoka,2008,PF,30,SAS,16,0,236,33,71,.465,16,40,.400,17,31,.548,.577,5,7,.714,7,40,47,17,11,2,11,25,87
Anderson VarejÃ£o,2008,C,25,CLE,13,0,240,22,54,.407,0,0,,22,54,.407,.407,9,21,.429,20,47,67,9,8,1,9,30,53
Jacque Vaughn,2008,PG,32,SAS,14,0,91,6,22,.273,0,1,.000,6,21,.286,.273,0,0,,2,7,9,8,2,0,7,17,12
Sasha VujaÄiÄ,2008,SG,23,LAL,21,0,456,55,138,.399,31,79,.392,24,59,.407,.511,30,35,.857,8,38,46,16,12,4,18,44,171
Ben Wallace*,2008,PF,33,CLE,13,13,304,17,33,.515,0,0,,17,33,.515,.515,7,20,.350,32,52,84,15,8,14,7,26,41
Rasheed Wallace,2008,C,33,DET,17,17,585,86,203,.424,24,75,.320,62,128,.484,.483,29,39,.744,19,89,108,28,19,33,29,67,225
Luke Walton,2008,SF,27,LAL,21,0,353,44,97,.454,11,26,.423,33,71,.465,.510,26,36,.722,13,42,55,41,11,4,20,49,125
Bonzi Wells,2008,SG,31,NOH,12,0,170,22,57,.386,0,2,.000,22,55,.400,.386,0,6,.000,4,27,31,8,4,3,6,26,44
David West,2008,PF,27,NOH,12,12,485,102,219,.466,1,2,.500,101,217,.465,.468,49,55,.891,21,81,102,34,13,23,21,32,254
Delonte West,2008,PG,24,CLE,13,13,453,44,110,.400,18,42,.429,26,68,.382,.482,35,41,.854,8,35,43,54,15,6,32,40,141
Mario West,2008,SG,23,ATL,6,0,6,1,3,.333,0,0,,1,3,.333,.333,0,1,.000,1,1,2,0,0,0,0,0,2
Deron Williams,2008,PG,23,UTA,12,12,513,90,183,.492,28,56,.500,62,127,.488,.568,51,66,.773,16,27,43,120,7,4,37,35,259
Lou Williams,2008,PG,21,PHI,6,0,135,24,60,.400,2,9,.222,22,51,.431,.417,22,30,.733,3,9,12,12,6,0,7,11,72
Marvin Williams,2008,SF,21,ATL,7,7,199,24,58,.414,0,0,,24,58,.414,.414,32,36,.889,11,17,28,5,2,3,13,21,80
Loren Woods,2008,C,29,HOU,1,0,1,1,1,1.000,0,0,,1,1,1.000,1.000,0,0,,1,0,1,0,0,0,0,0,2
Antoine Wright,2008,SG,23,DAL,1,0,7,0,0,,0,0,,0,0,,,0,0,,0,1,1,0,0,0,2,0,0
Julian Wright,2008,SF,20,NOH,11,0,131,20,44,.455,2,9,.222,18,35,.514,.477,5,6,.833,6,12,18,5,10,1,5,8,47
Nick Young,2008,SG,22,WAS,4,0,17,1,9,.111,0,2,.000,1,7,.143,.111,3,4,.750,1,1,2,1,2,0,1,1,5
Thaddeus Young,2008,PF,19,PHI,6,6,160,24,50,.480,1,5,.200,23,45,.511,.490,12,14,.857,15,12,27,4,7,0,4,7,61
Arron Afflalo,2009,SG,23,DET,4,0,66,10,21,.476,2,10,.200,8,11,.727,.524,3,5,.600,1,2,3,1,0,2,3,9,25
LaMarcus Aldridge,2009,PF,23,POR,6,6,237,51,104,.490,1,4,.250,50,100,.500,.495,14,20,.700,9,36,45,8,3,10,10,16,117
Ray Allen*,2009,SG,33,BOS,14,14,565,83,206,.403,35,100,.350,48,106,.453,.488,55,58,.948,13,42,55,37,15,5,25,35,256
Tony Allen,2009,SG,27,BOS,10,0,60,4,8,.500,0,0,,4,8,.500,.500,1,1,1.000,1,8,9,3,2,0,1,4,9
Rafer Alston,2009,PG,32,ORL,23,23,740,106,279,.380,36,113,.319,70,166,.422,.444,33,44,.750,3,53,56,94,33,4,40,53,281
Chris Andersen,2009,C,30,DEN,15,0,328,34,54,.630,0,1,.000,34,53,.642,.630,29,44,.659,29,66,95,9,5,32,8,42,97
Carmelo Anthony,2009,SF,24,DEN,16,16,612,146,322,.453,24,66,.364,122,256,.477,.491,119,144,.826,26,67,93,65,28,10,37,60,435
Joel Anthony,2009,C,26,MIA,6,2,88,4,5,.800,0,0,,4,5,.800,.800,2,2,1.000,9,10,19,2,0,7,1,9,10
Trevor Ariza,2009,SF,23,LAL,23,23,722,92,185,.497,40,84,.476,52,101,.515,.605,36,64,.563,22,75,97,54,36,10,38,73,260
Hilton Armstrong,2009,C,24,NOH,4,1,53,6,13,.462,0,0,,6,13,.462,.462,3,10,.300,3,5,8,1,4,1,6,15,15
Renaldo Balkman,2009,PF,24,DEN,8,0,20,2,6,.333,0,1,.000,2,5,.400,.333,0,0,,2,2,4,1,4,0,0,3,4
J.J. Barea,2009,SG,24,DAL,10,4,221,31,71,.437,5,16,.313,26,55,.473,.472,9,13,.692,3,17,20,34,3,0,6,13,76
Brent Barry,2009,SG,37,HOU,4,0,35,5,10,.500,3,8,.375,2,2,1.000,.650,0,0,,0,4,4,3,2,0,4,3,13
Brandon Bass,2009,C,23,DAL,10,0,192,33,60,.550,0,0,,33,60,.550,.550,28,31,.903,13,28,41,7,7,4,4,22,94
Tony Battie,2009,PF,32,ORL,21,0,128,21,45,.467,0,0,,21,45,.467,.467,3,5,.600,7,13,20,2,0,3,2,12,45
Shane Battier,2009,SG,30,HOU,13,13,496,33,81,.407,17,54,.315,16,27,.593,.512,22,23,.957,21,43,64,31,14,9,15,33,105
Nicolas Batum,2009,SF,20,POR,6,5,63,5,9,.556,2,4,.500,3,5,.600,.667,0,0,,1,2,3,1,1,2,3,7,12
Jerryd Bayless,2009,PG,20,POR,2,0,11,2,6,.333,0,1,.000,2,5,.400,.333,2,3,.667,0,1,1,0,0,1,1,0,6
Michael Beasley,2009,PF,20,MIA,7,0,178,34,88,.386,4,13,.308,30,75,.400,.409,13,17,.765,10,41,51,7,2,7,11,14,85
Mike Bibby,2009,PG,30,ATL,11,11,390,49,106,.462,26,48,.542,23,58,.397,.585,21,22,.955,6,31,37,46,10,2,24,34,145
Chauncey Billups,2009,PG,32,DEN,16,16,619,90,197,.457,44,94,.468,46,103,.447,.569,106,117,.906,5,56,61,109,20,4,31,38,330
Steve Blake,2009,PG,28,POR,6,6,231,22,45,.489,10,24,.417,12,21,.571,.600,5,7,.714,4,20,24,37,5,0,9,11,59
Matt Bonner,2009,PF,28,SAS,5,5,100,5,23,.217,3,13,.231,2,10,.200,.283,2,2,1.000,6,10,16,0,3,2,2,10,15
Carlos Boozer,2009,PF,27,UTA,5,5,186,38,72,.528,0,0,,38,72,.528,.528,27,35,.771,12,54,66,11,8,2,15,18,103
Bruce Bowen,2009,SF,37,SAS,5,2,130,7,13,.538,5,9,.556,2,4,.500,.731,2,2,1.000,0,15,15,3,3,0,3,10,21
Ryan Bowen,2009,SF,33,NOH,1,0,2,0,1,.000,0,0,,0,1,.000,.000,0,0,,0,0,0,0,0,0,0,1,0
Ronnie Brewer,2009,SF,23,UTA,5,5,158,20,49,.408,0,2,.000,20,47,.426,.408,11,16,.688,7,16,23,13,7,1,11,9,51
Aaron Brooks,2009,PG,24,HOU,13,13,444,77,170,.453,27,64,.422,50,106,.472,.532,37,46,.804,4,30,34,44,5,3,29,29,218
Devin Brown,2009,SG,30,NOH,3,0,33,3,8,.375,0,4,.000,3,4,.750,.375,2,2,1.000,2,3,5,0,0,0,3,2,8
Kwame Brown,2009,C,26,DET,3,0,48,3,8,.375,0,0,,3,8,.375,.375,3,4,.750,6,9,15,0,0,3,3,12,9
Shannon Brown,2009,SG,23,LAL,21,0,276,36,83,.434,12,25,.480,24,58,.414,.506,19,24,.792,8,17,25,13,10,2,10,27,103
Kobe Bryant*,2009,SG,30,LAL,23,23,940,242,530,.457,37,106,.349,205,424,.483,.492,174,197,.883,19,104,123,126,38,21,59,59,695
Rasual Butler,2009,SF,29,NOH,5,5,158,17,37,.459,10,19,.526,7,18,.389,.595,9,9,1.000,3,12,15,1,1,4,6,14,53
Andrew Bynum,2009,C,21,LAL,23,18,400,58,127,.457,0,0,,58,127,.457,.457,28,43,.651,33,53,86,10,8,21,19,77,144
Will Bynum,2009,PG,26,DET,4,0,78,18,39,.462,1,4,.250,17,35,.486,.474,10,10,1.000,1,5,6,10,5,0,8,9,47
Matt Carroll,2009,SG,28,DAL,4,0,14,1,2,.500,0,0,,1,2,.500,.500,0,0,,0,2,2,0,0,0,1,1,2
Anthony Carter,2009,PG,33,DEN,16,0,228,20,49,.408,2,12,.167,18,37,.486,.429,2,4,.500,11,21,32,34,15,1,11,27,44
Mario Chalmers,2009,PG,22,MIA,7,7,231,20,50,.400,6,21,.286,14,29,.483,.460,5,7,.714,6,13,19,31,20,1,17,21,51
Tyson Chandler,2009,C,26,NOH,4,4,94,6,12,.500,0,0,,6,12,.500,.500,3,6,.500,8,13,21,2,2,1,8,17,15
Speedy Claxton,2009,PG,30,ATL,1,0,3,0,0,,0,0,,0,0,,,0,0,,0,0,0,0,0,0,0,0,0
Jarron Collins,2009,C,30,UTA,3,3,35,1,5,.200,0,0,,1,5,.200,.200,6,8,.750,4,6,10,1,1,0,0,9,8
Brian Cook,2009,PF,28,HOU,6,0,32,4,15,.267,2,9,.222,2,6,.333,.333,0,0,,3,9,12,3,2,1,4,4,10
Daequan Cook,2009,SF,21,MIA,7,0,161,13,42,.310,9,30,.300,4,12,.333,.417,2,2,1.000,3,14,17,4,2,0,6,18,37
Samuel Dalembert,2009,C,27,PHI,6,6,133,16,25,.640,0,0,,16,25,.640,.640,3,4,.750,10,37,47,3,2,9,6,24,35
Erick Dampier,2009,C,33,DAL,10,10,255,22,36,.611,0,0,,22,36,.611,.611,13,21,.619,25,36,61,7,4,9,19,41,57
Antonio Daniels,2009,PG,33,NOH,5,0,64,2,13,.154,1,4,.250,1,9,.111,.192,9,11,.818,1,2,3,9,2,1,5,1,14
Glen Davis,2009,C,23,BOS,14,14,510,86,175,.491,0,0,,86,175,.491,.491,49,69,.710,33,46,79,25,18,8,20,59,221
Yakhouba Diawara,2009,SF,26,MIA,5,0,21,1,3,.333,0,1,.000,1,2,.500,.333,0,2,.000,0,5,5,0,1,0,0,2,2
Tim Duncan*,2009,C,32,SAS,5,5,164,41,77,.532,0,0,,41,77,.532,.532,17,28,.607,12,28,40,16,3,6,7,11,99
Maurice Evans,2009,SF,30,ATL,11,8,265,28,65,.431,8,28,.286,20,37,.541,.492,4,6,.667,8,8,16,10,6,3,4,29,68
Reggie Evans,2009,PF,28,PHI,5,0,36,2,9,.222,0,0,,2,9,.222,.222,3,4,.750,2,8,10,0,3,0,2,4,7
Jordan Farmar,2009,PG,22,LAL,20,1,260,34,87,.391,12,39,.308,22,48,.458,.460,14,19,.737,5,23,28,33,9,3,18,16,94
Rudy FernÃ¡ndez,2009,SG,23,POR,6,1,162,15,35,.429,8,19,.421,7,16,.438,.543,7,7,1.000,2,15,17,6,8,3,9,12,45
Michael Finley,2009,SF,35,SAS,5,5,143,15,34,.441,7,15,.467,8,19,.421,.544,3,4,.750,3,12,15,5,1,1,4,8,40
Derek Fisher,2009,PG,34,LAL,22,22,635,63,160,.394,19,67,.284,44,93,.473,.453,31,36,.861,7,38,45,49,21,1,24,61,176
Adonal Foyle,2009,C,33,ORL,2,0,4,0,1,.000,0,0,,0,1,.000,.000,0,0,,0,1,1,0,0,0,1,1,0
Channing Frye,2009,PF,25,POR,4,0,36,5,14,.357,0,0,,5,14,.357,.357,2,3,.667,1,2,3,1,0,0,0,5,12
Thomas Gardner,2009,SG,23,ATL,3,0,19,5,13,.385,3,6,.500,2,7,.286,.500,1,1,1.000,0,2,2,2,1,0,0,4,14
Pau Gasol,2009,C,28,LAL,23,23,931,160,276,.580,0,0,,160,276,.580,.580,100,140,.714,68,181,249,58,19,45,44,69,420
Daniel Gibson,2009,PG,22,CLE,14,0,172,13,40,.325,10,28,.357,3,12,.250,.450,11,11,1.000,1,6,7,6,1,3,7,18,47
Drew Gooden,2009,PF,27,SAS,4,0,71,11,33,.333,0,2,.000,11,31,.355,.333,7,7,1.000,5,10,15,1,1,1,3,13,29
Ben Gordon,2009,SG,25,CHI,7,7,304,52,134,.388,17,46,.370,35,88,.398,.451,49,56,.875,3,17,20,21,3,1,8,22,170
Marcin Gortat,2009,PF,24,ORL,24,1,271,34,52,.654,0,0,,34,52,.654,.654,10,16,.625,18,58,76,3,9,15,11,39,78
Aaron Gray,2009,C,24,CHI,2,0,9,0,2,.000,0,0,,0,2,.000,.000,0,0,,0,1,1,0,0,0,1,0,0
Gerald Green,2009,SG,23,DAL,6,0,26,4,14,.286,1,5,.200,3,9,.333,.321,2,4,.500,0,2,2,0,1,0,2,4,11
Willie Green,2009,SG,27,PHI,6,6,148,21,51,.412,4,11,.364,17,40,.425,.451,1,3,.333,0,6,6,7,0,1,5,13,47
Richard Hamilton,2009,SG,30,DET,4,4,154,21,59,.356,2,10,.200,19,49,.388,.373,9,10,.900,2,9,11,20,5,1,10,12,53
Matt Harpring,2009,SG,32,UTA,5,0,49,11,22,.500,0,1,.000,11,21,.524,.500,2,2,1.000,3,6,9,4,2,1,2,12,24
Jason Hart,2009,PG,30,DEN,9,0,19,1,2,.500,0,0,,1,2,.500,.500,0,0,,0,3,3,5,2,1,1,5,2
Udonis Haslem,2009,PF,28,MIA,7,7,204,25,46,.543,0,0,,25,46,.543,.543,9,10,.900,13,48,61,3,3,3,6,19,59
Chuck Hayes,2009,C,25,HOU,13,4,173,10,21,.476,0,2,.000,10,19,.526,.476,0,0,,13,26,39,10,13,2,4,27,20
Walter Herrmann,2009,SF,29,DET,4,0,22,3,8,.375,2,4,.500,1,4,.250,.500,0,0,,1,0,1,2,1,0,0,3,8
NenÃª,2009,C,26,DEN,16,16,525,69,126,.548,0,0,,69,126,.548,.548,46,70,.657,37,83,120,42,20,10,31,65,184
George Hill,2009,PG,22,SAS,4,0,76,7,21,.333,3,8,.375,4,13,.308,.405,6,7,.857,3,5,8,2,2,1,2,6,23
Kirk Hinrich,2009,SG,28,CHI,7,0,210,29,62,.468,13,30,.433,16,32,.500,.573,17,25,.680,2,17,19,20,12,3,8,18,88
Ryan Hollins,2009,C,24,DAL,9,0,84,8,14,.571,0,0,,8,14,.571,.571,6,10,.600,9,15,24,1,1,4,4,22,22
Al Horford,2009,C,22,ATL,9,9,252,25,59,.424,0,1,.000,25,58,.431,.424,12,18,.667,12,40,52,18,6,6,4,26,62
Eddie House,2009,PG,30,BOS,14,0,232,40,77,.519,18,37,.486,22,40,.550,.636,10,11,.909,2,18,20,13,11,0,6,26,108
Dwight Howard,2009,C,23,ORL,23,23,903,161,268,.601,0,2,.000,161,266,.605,.601,145,228,.636,99,254,353,43,20,60,67,102,467
Josh Howard,2009,SF,28,DAL,10,10,295,56,128,.438,8,32,.250,48,96,.500,.469,38,49,.776,10,41,51,13,9,4,21,24,158
Lindsey Hunter,2009,PG,38,CHI,6,0,24,1,3,.333,1,3,.333,0,0,,.500,3,4,.750,0,5,5,5,2,0,0,3,6
Othello Hunter,2009,PF,22,ATL,4,0,14,2,3,.667,0,0,,2,3,.667,.667,0,0,,3,3,6,0,1,1,0,1,4
Andre Iguodala,2009,SF,25,PHI,6,6,269,44,98,.449,11,28,.393,33,70,.471,.505,30,46,.652,6,32,38,40,11,0,24,9,129
Zydrunas Ilgauskas,2009,C,33,CLE,14,14,407,62,138,.449,2,13,.154,60,125,.480,.457,21,33,.636,27,82,109,17,5,13,9,47,147
D.J. Mbenga,2009,C,28,LAL,7,0,16,1,6,.167,0,0,,1,6,.167,.167,0,0,,0,3,3,0,0,2,2,0,2
Royal Ivey,2009,SG,27,PHI,6,0,45,3,11,.273,2,7,.286,1,4,.250,.364,3,4,.750,1,3,4,0,3,0,0,6,11
Darnell Jackson,2009,PF,23,CLE,5,0,25,1,5,.200,0,0,,1,5,.200,.200,0,2,.000,0,5,5,1,0,0,1,5,2
LeBron James,2009,SF,24,CLE,14,14,580,159,312,.510,27,81,.333,132,231,.571,.553,149,199,.749,19,109,128,102,23,12,38,30,494
Amir Johnson,2009,PF,21,DET,3,0,13,1,1,1.000,0,0,,1,1,1.000,1.000,0,0,,1,2,3,0,0,1,0,3,2
Anthony Johnson,2009,PG,34,ORL,19,1,280,32,85,.376,9,30,.300,23,55,.418,.429,9,18,.500,7,19,26,39,11,0,12,28,82
Joe Johnson,2009,SG,27,ATL,11,11,429,70,168,.417,12,35,.343,58,133,.436,.452,28,45,.622,17,32,49,39,14,0,32,24,180
Linton Johnson,2009,PF,28,CHI,3,0,10,1,2,.500,0,0,,1,2,.500,.500,2,2,1.000,2,2,4,1,0,0,0,1,4
Dahntay Jones,2009,SG,28,DEN,16,16,280,38,79,.481,3,12,.250,35,67,.522,.500,33,43,.767,16,22,38,10,13,5,13,41,112
James Jones,2009,SF,28,MIA,7,7,235,17,32,.531,11,22,.500,6,10,.600,.703,22,24,.917,2,14,16,5,3,1,4,19,67
Solomon Jones,2009,C,24,ATL,9,1,77,6,12,.500,0,0,,6,12,.500,.500,2,2,1.000,9,7,16,2,1,0,1,9,14
Jason Kidd*,2009,PG,35,DAL,10,10,386,38,83,.458,21,47,.447,17,36,.472,.584,17,20,.850,7,51,58,59,22,3,20,24,114
Tarence Kinsey,2009,SG,24,CLE,9,0,11,1,3,.333,0,0,,1,3,.333,.333,2,2,1.000,1,1,2,0,1,0,1,2,4
Andrei Kirilenko,2009,PF,27,UTA,5,3,136,22,47,.468,1,5,.200,21,42,.500,.479,10,14,.714,7,7,14,10,11,3,5,6,55
Linas Kleiza,2009,SF,24,DEN,14,0,210,31,66,.470,17,40,.425,14,26,.538,.598,18,24,.750,8,37,45,7,5,1,2,17,97
Brevin Knight,2009,PG,33,UTA,5,0,17,0,3,.000,0,0,,0,3,.000,.000,0,0,,0,1,1,3,1,0,3,4,0
Kyle Korver,2009,SF,27,UTA,5,2,136,18,46,.391,12,26,.462,6,20,.300,.522,5,7,.714,2,9,11,13,3,1,2,9,53
Carl Landry,2009,PF,25,HOU,13,0,240,39,70,.557,0,2,.000,39,68,.574,.557,19,33,.576,16,35,51,3,4,5,14,27,97
Acie Law,2009,PG,24,ATL,6,0,28,3,9,.333,1,3,.333,2,6,.333,.389,1,1,1.000,1,1,2,6,0,0,1,3,8
Courtney Lee,2009,SG,23,ORL,21,16,550,67,154,.435,12,44,.273,55,110,.500,.474,23,26,.885,6,33,39,27,19,3,20,42,169
Rashard Lewis,2009,PF,29,ORL,24,24,986,156,348,.448,52,132,.394,104,216,.481,.523,91,116,.784,29,124,153,70,25,13,50,50,455
Kyle Lowry,2009,PG,22,HOU,13,0,254,21,63,.333,4,16,.250,17,47,.362,.365,23,31,.742,8,30,38,32,12,1,17,23,69
Tyronn Lue,2009,PG,31,ORL,1,0,4,2,2,1.000,1,1,1.000,1,1,1.000,1.250,0,0,,0,0,0,0,0,0,0,0,5
Jamaal Magloire,2009,C,30,MIA,6,0,47,1,3,.333,0,0,,1,3,.333,.333,0,0,,5,6,11,1,0,0,3,9,2
Stephon Marbury,2009,PG,31,BOS,14,0,166,20,66,.303,3,12,.250,17,54,.315,.326,9,9,1.000,2,11,13,25,1,0,10,15,52
Sean Marks,2009,C,33,NOH,5,0,80,6,13,.462,0,1,.000,6,12,.500,.462,4,5,.800,10,10,20,0,3,2,2,9,16
Donyell Marshall,2009,PF,35,PHI,6,0,50,6,16,.375,4,11,.364,2,5,.400,.500,0,0,,0,7,7,0,1,1,2,9,16
Kenyon Martin,2009,PF,31,DEN,16,16,538,75,151,.497,1,5,.200,74,146,.507,.500,23,35,.657,24,70,94,34,18,14,26,60,174
Roger Mason,2009,SG,28,SAS,5,3,108,12,32,.375,7,19,.368,5,13,.385,.484,2,3,.667,0,8,8,9,1,0,4,10,33
Jason Maxiell,2009,C,25,DET,4,0,64,5,10,.500,0,0,,5,10,.500,.500,5,9,.556,7,6,13,2,1,1,1,5,15
Antonio McDyess,2009,PF,34,DET,4,4,136,23,44,.523,0,0,,23,44,.523,.523,6,6,1.000,6,28,34,2,2,3,5,17,52
C.J. Miles,2009,SG,21,UTA,5,0,58,6,20,.300,2,8,.250,4,12,.333,.350,3,4,.750,2,5,7,1,2,1,3,8,17
Andre Miller,2009,PG,32,PHI,6,6,258,48,101,.475,3,10,.300,45,91,.495,.490,28,34,.824,9,29,38,32,7,1,19,17,127
Brad Miller,2009,C,32,CHI,7,0,186,24,51,.471,5,7,.714,19,44,.432,.520,19,24,.792,11,44,55,9,2,6,21,25,72
Paul Millsap,2009,PF,23,UTA,5,0,155,25,49,.510,0,0,,25,49,.510,.510,9,18,.500,20,20,40,8,4,5,6,17,59
Yao Ming*,2009,C,28,HOU,9,9,323,54,99,.545,0,0,,54,99,.545,.545,46,51,.902,19,79,98,9,4,11,17,27,154
Jamario Moon,2009,SF,28,MIA,3,0,40,5,5,1.000,2,2,1.000,3,3,1.000,1.200,0,2,.000,3,6,9,1,1,1,2,5,12
Mikki Moore,2009,C,33,BOS,10,0,66,5,10,.500,0,0,,5,10,.500,.500,5,6,.833,6,9,15,4,2,5,1,11,15
Randolph Morris,2009,C,23,ATL,3,0,8,0,1,.000,0,0,,0,1,.000,.000,0,0,,1,1,2,0,1,0,1,2,0
Ronald Murray,2009,SG,29,ATL,11,0,341,42,123,.341,14,50,.280,28,73,.384,.398,32,37,.865,6,24,30,28,12,3,14,17,130
Dikembe Mutombo*,2009,C,42,HOU,2,0,20,0,0,,0,0,,0,0,,,0,2,.000,1,8,9,0,1,2,0,5,0
Jameer Nelson,2009,PG,26,ORL,5,0,90,8,23,.348,1,6,.167,7,17,.412,.370,2,4,.500,1,6,7,14,1,0,7,3,19
Joakim Noah,2009,C,23,CHI,7,7,271,26,51,.510,0,0,,26,51,.510,.510,19,25,.760,28,64,92,16,6,15,8,31,71
Dirk Nowitzki,2009,PF,30,DAL,10,10,394,88,170,.518,6,21,.286,82,149,.550,.535,86,93,.925,12,89,101,31,9,8,23,21,268
Jermaine O'Neal,2009,C,30,MIA,6,5,162,28,51,.549,0,0,,28,51,.549,.549,24,32,.750,7,20,27,9,3,9,10,18,80
Fabricio Oberto,2009,C,33,SAS,2,0,22,4,6,.667,0,0,,4,6,.667,.667,4,4,1.000,2,2,4,0,2,0,2,2,12
Greg Oden,2009,C,21,POR,6,0,96,11,21,.524,0,0,,11,21,.524,.524,8,12,.667,11,15,26,0,2,5,8,27,30
Lamar Odom,2009,PF,29,LAL,23,5,735,108,206,.524,18,35,.514,90,171,.526,.568,49,80,.613,64,146,210,42,16,31,39,75,283
Mehmet Okur,2009,C,29,UTA,2,2,43,2,12,.167,1,3,.333,1,9,.111,.208,3,4,.750,2,8,10,4,0,1,2,6,8
Travis Outlaw,2009,SF,24,POR,6,0,170,21,66,.318,4,16,.250,17,50,.340,.348,8,12,.667,2,16,18,3,5,4,5,10,54
Zaza Pachulia,2009,C,24,ATL,11,1,260,22,53,.415,0,0,,22,53,.415,.415,32,42,.762,28,48,76,3,5,3,14,40,76
Tony Parker,2009,PG,26,SAS,5,5,181,59,108,.546,3,14,.214,56,94,.596,.560,22,31,.710,1,20,21,34,6,1,21,13,143
Chris Paul,2009,PG,23,NOH,5,5,201,30,73,.411,5,16,.313,25,57,.439,.445,18,21,.857,4,18,22,52,8,0,24,8,83
Sasha PavloviÄ,2009,SF,25,CLE,11,0,91,10,20,.500,2,8,.250,8,12,.667,.550,1,3,.333,1,14,15,4,4,0,3,9,23
Kendrick Perkins,2009,C,24,BOS,14,14,512,73,127,.575,0,1,.000,73,126,.579,.575,20,30,.667,51,111,162,20,6,37,33,51,166
Morris Peterson,2009,SG,31,NOH,2,0,21,1,5,.200,1,3,.333,0,2,.000,.300,3,4,.750,1,2,3,1,1,0,0,3,6
Johan Petro,2009,C,23,DEN,10,0,26,2,9,.222,0,0,,2,9,.222,.222,5,8,.625,2,4,6,1,0,1,1,4,9
Paul Pierce*,2009,SF,31,BOS,14,14,556,95,221,.430,19,57,.333,76,164,.463,.473,85,101,.842,4,77,81,43,15,5,33,44,294
MickaÃ«l PiÃ©trus,2009,SG,26,ORL,24,0,618,84,174,.483,37,96,.385,47,78,.603,.589,47,65,.723,19,43,62,14,18,13,22,77,252
James Posey,2009,SG,32,NOH,5,0,123,15,40,.375,5,19,.263,10,21,.476,.438,22,26,.846,5,26,31,3,3,0,10,12,57
Leon Powe,2009,PF,25,BOS,2,0,24,3,7,.429,0,0,,3,7,.429,.429,4,6,.667,1,8,9,0,0,0,1,3,10
Josh Powell,2009,PF,26,LAL,14,0,73,11,26,.423,1,1,1.000,10,25,.400,.442,6,6,1.000,7,10,17,4,0,1,4,8,29
Ronnie Price,2009,PG,25,UTA,2,0,16,3,10,.300,0,3,.000,3,7,.429,.300,2,2,1.000,3,0,3,5,1,0,0,4,8
Tayshaun Prince,2009,SF,28,DET,4,4,129,7,27,.259,1,5,.200,6,22,.273,.278,0,0,,1,13,14,5,1,0,5,4,15
Gabe Pruitt,2009,SG,22,BOS,4,0,11,0,3,.000,0,1,.000,0,2,.000,.000,0,0,,0,0,0,2,0,1,2,0,0
Joel Przybilla,2009,C,29,POR,6,6,162,10,18,.556,0,0,,10,18,.556,.556,3,6,.500,19,25,44,8,4,12,3,21,23
Chris Quinn,2009,PG,25,MIA,5,0,24,3,7,.429,0,1,.000,3,6,.500,.429,2,2,1.000,0,1,1,5,2,0,2,1,8
Theo Ratliff,2009,C,35,PHI,6,0,94,9,11,.818,0,0,,9,11,.818,.818,2,4,.500,6,17,23,0,1,4,4,24,20
J.J. Redick,2009,SG,24,ORL,16,8,327,31,83,.373,21,52,.404,10,31,.323,.500,13,14,.929,2,17,19,31,8,1,7,26,96
Jeremy Richardson,2009,SF,24,ORL,1,0,2,0,1,.000,0,0,,0,1,.000,.000,0,0,,0,0,0,0,0,0,1,0,0
Anthony Roberson,2009,PG,25,CHI,1,0,4,3,4,.750,2,2,1.000,1,2,.500,1.000,0,0,,1,0,1,0,2,0,1,0,8
Sergio RodrÃ­guez,2009,PG,22,POR,5,0,27,2,6,.333,0,0,,2,6,.333,.333,0,0,,1,2,3,7,0,1,2,5,4
Rajon Rondo,2009,PG,22,BOS,14,14,577,93,223,.417,6,24,.250,87,199,.437,.430,44,67,.657,32,104,136,137,35,3,38,47,236
Derrick Rose,2009,PG,20,CHI,7,7,313,59,120,.492,0,4,.000,59,116,.509,.492,20,25,.800,12,32,44,45,4,5,35,25,138
Brandon Roy,2009,SG,24,POR,6,6,238,56,122,.459,8,17,.471,48,105,.457,.492,40,46,.870,6,23,29,17,8,7,13,15,160
Michael Ruffin,2009,PF,32,POR,1,0,5,0,1,.000,0,0,,0,1,.000,.000,1,2,.500,3,2,5,0,0,0,1,1,1
John Salmons,2009,SF,29,CHI,7,7,313,43,107,.402,12,38,.316,31,69,.449,.458,29,34,.853,6,25,31,16,9,7,12,20,127
Brian Scalabrine,2009,C,30,BOS,12,0,246,22,52,.423,13,29,.448,9,23,.391,.548,4,4,1.000,7,19,26,12,2,5,5,43,61
Luis Scola,2009,PF,28,HOU,13,13,424,77,156,.494,0,0,,77,156,.494,.494,33,49,.673,28,81,109,23,7,3,22,45,187
James Singleton,2009,PF,27,DAL,9,0,42,5,10,.500,2,5,.400,3,5,.600,.600,0,2,.000,2,4,6,0,0,1,2,8,12
J.R. Smith,2009,SG,23,DEN,16,0,435,88,194,.454,38,106,.358,50,88,.568,.552,25,46,.543,11,42,53,45,17,4,26,51,239
Joe Smith,2009,C,33,CLE,13,0,218,23,50,.460,3,5,.600,20,45,.444,.490,23,29,.793,10,38,48,3,6,7,7,25,72
Josh Smith,2009,PF,23,ATL,11,11,410,67,159,.421,2,15,.133,65,144,.451,.428,52,71,.732,24,58,82,24,12,17,21,36,188
Marreese Speights,2009,C,21,PHI,3,0,29,3,7,.429,0,0,,3,7,.429,.429,3,4,.750,3,3,6,0,0,0,0,5,9
Peja StojakoviÄ,2009,SF,31,NOH,5,5,162,18,49,.367,8,26,.308,10,23,.435,.449,12,13,.923,4,10,14,2,4,1,6,17,56
Rodney Stuckey,2009,PG,22,DET,4,4,128,24,61,.393,0,8,.000,24,53,.453,.393,12,14,.857,2,7,9,21,0,0,6,9,60
Wally Szczerbiak,2009,SF,31,CLE,12,0,154,16,36,.444,2,12,.167,14,24,.583,.472,9,11,.818,8,20,28,7,2,1,9,19,43
Jason Terry,2009,SG,31,DAL,10,1,325,49,126,.389,22,59,.373,27,67,.403,.476,23,30,.767,6,22,28,19,6,3,16,18,143
Kurt Thomas,2009,PF,36,SAS,5,0,80,5,11,.455,0,0,,5,11,.455,.455,3,4,.750,4,19,23,2,1,2,4,13,13
Tim Thomas,2009,PF,31,CHI,2,0,15,3,10,.300,1,4,.250,2,6,.333,.350,0,0,,0,3,3,0,0,0,1,4,7
Tyrus Thomas,2009,PF,22,CHI,7,7,195,28,64,.438,0,1,.000,28,63,.444,.438,11,14,.786,8,36,44,6,7,20,11,23,67
Hedo TÃ¼rkoÄlu,2009,SF,29,ORL,24,24,934,126,295,.427,32,83,.386,94,212,.443,.481,94,115,.817,9,100,109,116,18,4,64,80,378
Ime Udoka,2009,SF,31,SAS,5,0,104,7,20,.350,1,8,.125,6,12,.500,.375,2,5,.400,8,15,23,4,4,1,2,14,17
Anderson VarejÃ£o,2009,PF,26,CLE,14,14,420,41,82,.500,0,0,,41,82,.500,.500,15,22,.682,41,49,90,8,18,16,15,49,97
Jacque Vaughn,2009,PG,33,SAS,2,0,21,2,5,.400,0,0,,2,5,.400,.400,3,6,.500,0,0,0,4,1,0,0,0,7
Sasha VujaÄiÄ,2009,SG,24,LAL,23,0,250,24,91,.264,16,51,.314,8,40,.200,.352,5,6,.833,7,25,32,12,10,4,10,34,69
Dwyane Wade,2009,SG,27,MIA,7,7,285,68,155,.439,18,50,.360,50,105,.476,.497,50,58,.862,4,31,35,37,6,11,25,20,204
Von Wafer,2009,SG,23,HOU,13,0,181,39,92,.424,9,22,.409,30,70,.429,.473,19,22,.864,0,12,12,9,2,1,11,11,106
Henry Walker,2009,SF,21,BOS,4,0,10,0,2,.000,0,0,,0,2,.000,.000,2,2,1.000,0,0,0,0,2,0,2,2,2
Ben Wallace*,2009,PF,34,CLE,14,0,176,8,13,.615,0,0,,8,13,.615,.615,0,6,.000,18,20,38,4,4,4,3,13,16
Rasheed Wallace,2009,C,34,DET,4,4,122,11,30,.367,4,8,.500,7,22,.318,.433,0,0,,2,23,25,3,2,1,3,12,26
Luke Walton,2009,SF,28,LAL,21,0,332,32,75,.427,5,16,.313,27,59,.458,.460,11,18,.611,16,36,52,45,14,3,20,41,80
David West,2009,PF,28,NOH,5,5,178,32,80,.400,0,0,,32,80,.400,.400,26,29,.897,5,32,37,6,5,2,14,19,90
Delonte West,2009,SG,25,CLE,14,14,591,73,157,.465,12,36,.333,61,121,.504,.503,35,42,.833,6,43,49,58,19,7,34,28,193
Mario West,2009,SG,24,ATL,11,0,46,2,10,.200,0,1,.000,2,9,.222,.200,1,4,.250,0,5,5,2,2,0,1,2,5
James White,2009,SF,26,HOU,5,0,12,3,9,.333,1,2,.500,2,7,.286,.389,0,0,,1,0,1,0,0,0,1,0,7
Deron Williams,2009,PG,24,UTA,5,5,211,29,70,.414,9,25,.360,20,45,.444,.479,34,41,.829,4,15,19,54,9,2,21,17,101
Lou Williams,2009,SG,22,PHI,6,0,149,21,51,.412,6,16,.375,15,35,.429,.471,10,15,.667,2,13,15,17,3,1,12,10,58
Marvin Williams,2009,SF,22,ATL,6,3,97,10,29,.345,1,6,.167,9,23,.391,.362,9,13,.692,3,6,9,6,5,2,6,8,30
Mo Williams,2009,PG,26,CLE,14,14,541,80,196,.408,35,94,.372,45,102,.441,.497,33,43,.767,9,36,45,58,10,1,30,43,228
Metta World Peace,2009,SF,29,HOU,13,13,488,80,203,.394,23,83,.277,57,120,.475,.451,20,28,.714,12,44,56,54,14,3,32,27,203
Antoine Wright,2009,SF,24,DAL,10,5,167,21,43,.488,8,21,.381,13,22,.591,.581,9,11,.818,5,8,13,10,3,2,4,30,59
Dorell Wright,2009,SF,23,MIA,1,0,3,0,0,,0,0,,0,0,,,0,0,,0,0,0,0,0,0,0,0,0
Julian Wright,2009,SF,21,NOH,4,0,32,3,7,.429,0,0,,3,7,.429,.429,2,4,.500,0,6,6,2,0,1,1,6,8
Thaddeus Young,2009,PF,20,PHI,6,6,229,31,70,.443,5,12,.417,26,58,.448,.479,5,6,.833,9,18,27,8,6,1,8,17,72
Arron Afflalo,2010,SG,24,DEN,6,6,120,20,32,.625,6,14,.429,14,18,.778,.719,9,11,.818,1,11,12,7,1,2,4,21,55
LaMarcus Aldridge,2010,PF,24,POR,6,6,229,40,93,.430,1,2,.500,39,91,.429,.435,33,44,.750,10,26,36,13,7,11,11,16,114
Malik Allen,2010,PF,31,DEN,4,0,11,0,1,.000,0,0,,0,1,.000,.000,0,0,,2,1,3,0,1,0,0,2,0
Ray Allen*,2010,SG,34,BOS,24,24,925,131,304,.431,56,145,.386,75,159,.472,.523,69,80,.863,12,68,80,63,22,3,36,74,387
Tony Allen,2010,SG,28,BOS,24,0,391,47,98,.480,0,5,.000,47,93,.505,.480,28,36,.778,13,28,41,17,25,14,23,58,122
Lou Amundson,2010,PF,27,PHO,16,0,194,19,36,.528,0,0,,19,36,.528,.528,9,21,.429,30,26,56,1,6,7,6,31,47
Chris Andersen,2010,PF,31,DEN,6,0,116,9,17,.529,0,0,,9,17,.529,.529,9,14,.643,7,20,27,1,1,6,4,14,27
Ryan Anderson,2010,PF,21,ORL,9,0,89,9,29,.310,4,14,.286,5,15,.333,.379,1,1,1.000,8,23,31,3,2,2,5,12,23
Carmelo Anthony,2010,SF,25,DEN,6,6,254,64,138,.464,6,19,.316,58,119,.487,.486,50,57,.877,14,37,51,20,12,3,21,26,184
Joel Anthony,2010,C,27,MIA,5,0,79,5,7,.714,0,0,,5,7,.714,.714,3,4,.750,6,3,9,1,2,5,1,9,13
Carlos Arroyo,2010,PG,30,MIA,5,5,115,12,26,.462,0,1,.000,12,25,.480,.462,2,2,1.000,2,7,9,11,3,0,3,9,26
D.J. Augustin,2010,PG,22,CHA,4,0,73,5,17,.294,2,6,.333,3,11,.273,.353,5,6,.833,1,3,4,7,1,1,4,4,17
Jeff Ayres,2010,C,22,POR,3,0,17,2,4,.500,0,0,,2,4,.500,.500,3,4,.750,2,0,2,0,2,3,1,1,7
Leandro Barbosa,2010,PG,27,PHO,16,0,250,43,103,.417,12,35,.343,31,68,.456,.476,17,24,.708,2,19,21,20,5,2,15,33,115
J.J. Barea,2010,PG,25,DAL,6,0,105,15,37,.405,4,10,.400,11,27,.407,.459,1,3,.333,4,8,12,15,2,1,10,13,35
Matt Barnes,2010,SF,29,ORL,14,14,326,30,75,.400,12,32,.375,18,43,.419,.480,17,20,.850,16,50,66,19,10,3,10,28,89
Brandon Bass,2010,PF,24,ORL,7,0,42,7,13,.538,0,0,,7,13,.538,.538,5,6,.833,2,6,8,1,0,0,1,2,19
Nicolas Batum,2010,SF,21,POR,6,6,139,17,37,.459,9,21,.429,8,16,.500,.581,6,8,.750,4,15,19,5,2,0,4,13,49
Jerryd Bayless,2010,SG,21,POR,6,2,166,28,65,.431,6,15,.400,22,50,.440,.477,19,24,.792,4,12,16,23,2,0,8,21,81
Michael Beasley,2010,PF,21,MIA,5,5,135,22,49,.449,1,2,.500,21,47,.447,.459,7,9,.778,10,19,29,3,4,0,13,10,52
Rodrigue Beaubois,2010,PG,21,DAL,4,0,31,9,19,.474,2,6,.333,7,13,.538,.526,1,3,.333,2,4,6,4,0,0,3,5,21
Charlie Bell,2010,SG,30,MIL,3,0,8,0,2,.000,0,1,.000,0,1,.000,.000,0,0,,0,0,0,0,0,0,0,2,0
Mike Bibby,2010,PG,31,ATL,11,11,292,36,80,.450,14,34,.412,22,46,.478,.538,7,10,.700,5,23,28,28,9,0,12,26,93
Chauncey Billups,2010,PG,33,DEN,6,6,207,37,83,.446,11,31,.355,26,52,.500,.512,37,42,.881,1,13,14,38,6,3,18,24,122
DeJuan Blair,2010,PF,20,SAS,10,0,91,16,32,.500,0,0,,16,32,.500,.500,5,9,.556,19,20,39,5,5,4,2,18,37
Keith Bogans,2010,SF,29,SAS,8,0,55,2,10,.200,1,6,.167,1,4,.250,.250,0,0,,1,5,6,2,2,1,2,9,5
Matt Bonner,2010,PF,29,SAS,10,0,173,19,44,.432,10,27,.370,9,17,.529,.545,2,2,1.000,7,25,32,4,1,3,7,22,50
Carlos Boozer,2010,PF,28,UTA,10,10,402,89,168,.530,0,0,,89,168,.530,.530,19,35,.543,33,99,132,30,4,7,24,38,197
PrimoÅ¾ Brezec,2010,C,30,MIL,4,0,25,4,7,.571,0,0,,4,7,.571,.571,1,2,.500,1,2,3,0,1,0,0,5,9
Derrick Brown,2010,SF,22,CHA,2,0,1,1,1,1.000,0,0,,1,1,1.000,1.000,0,0,,0,0,0,0,0,0,0,0,2
Devin Brown,2010,SG,31,CHI,1,0,2,1,1,1.000,0,0,,1,1,1.000,1.000,0,1,.000,0,1,1,0,0,0,0,0,2
Shannon Brown,2010,SG,24,LAL,23,0,324,42,107,.393,9,32,.281,33,75,.440,.435,20,28,.714,7,22,29,20,10,7,13,37,113
Kobe Bryant*,2010,SG,31,LAL,23,23,923,234,511,.458,49,131,.374,185,380,.487,.506,154,183,.842,26,112,138,126,31,16,79,75,671
Caron Butler,2010,SG,29,DAL,6,6,202,43,99,.434,7,23,.304,36,76,.474,.470,25,27,.926,3,32,35,8,9,5,15,16,118
Andrew Bynum,2010,C,22,LAL,23,23,561,80,149,.537,0,0,,80,149,.537,.537,38,56,.679,59,100,159,12,6,36,21,61,198
Marcus Camby,2010,C,35,POR,6,6,178,16,38,.421,0,1,.000,16,37,.432,.421,3,6,.500,16,44,60,14,4,7,3,18,35
Matt Carroll,2010,SG,29,DAL,1,0,5,1,1,1.000,0,0,,1,1,1.000,1.000,0,0,,0,1,1,0,0,0,0,0,2
Anthony Carter,2010,PG,34,DEN,1,0,7,0,1,.000,0,0,,0,1,.000,.000,0,0,,0,0,0,3,0,0,0,0,0
Vince Carter,2010,SG,33,ORL,14,14,480,74,184,.402,12,51,.235,62,133,.466,.435,57,69,.826,9,50,59,32,12,3,22,50,217
Mario Chalmers,2010,PG,23,MIA,5,0,131,18,40,.450,7,20,.350,11,20,.550,.538,11,13,.846,1,8,9,13,3,0,12,18,54
Tyson Chandler,2010,C,27,CHA,4,0,60,6,11,.545,0,0,,6,11,.545,.545,2,3,.667,3,7,10,2,2,3,4,16,14
Earl Clark,2010,PF,22,PHO,3,0,13,1,3,.333,0,0,,1,3,.333,.333,2,2,1.000,0,2,2,1,1,0,2,1,4
Jarron Collins,2010,C,31,PHO,11,10,115,5,15,.333,0,0,,5,15,.333,.333,2,2,1.000,9,8,17,0,1,1,3,22,12
Jason Collins,2010,C,31,ATL,3,0,10,3,5,.600,0,0,,3,5,.600,.600,0,0,,3,2,5,0,0,0,1,7,6
Nick Collison,2010,C,29,OKC,6,0,129,8,24,.333,0,1,.000,8,23,.348,.333,3,7,.429,12,16,28,2,5,1,4,20,19
Jamal Crawford,2010,SG,29,ATL,11,0,351,56,154,.364,18,50,.360,38,104,.365,.422,49,58,.845,1,29,30,30,9,1,20,26,179
Dante Cunningham,2010,PF,22,POR,5,0,42,9,15,.600,0,1,.000,9,14,.643,.600,5,6,.833,5,8,13,0,5,0,3,10,23
Erick Dampier,2010,C,34,DAL,5,4,118,0,8,.000,0,0,,0,8,.000,.000,5,12,.417,18,15,33,3,1,5,6,19,5
Marquis Daniels,2010,SF,29,BOS,11,0,37,5,13,.385,1,2,.500,4,11,.364,.423,6,6,1.000,5,5,10,1,0,0,3,4,17
Glen Davis,2010,PF,24,BOS,24,1,483,59,124,.476,0,3,.000,59,121,.488,.476,57,79,.722,39,70,109,10,19,9,22,54,175
Carlos Delfino,2010,SF,27,MIL,7,7,226,26,73,.356,15,37,.405,11,36,.306,.459,3,4,.750,3,25,28,18,5,2,12,14,70
Luol Deng,2010,SF,24,CHI,5,5,203,37,80,.463,1,12,.083,36,68,.529,.469,19,26,.731,8,17,25,7,6,4,3,15,94
Boris Diaw,2010,PF,27,CHA,4,4,152,14,28,.500,1,9,.111,13,19,.684,.518,1,2,.500,7,13,20,16,1,3,12,11,30
Travis Diener,2010,PG,27,POR,2,0,7,0,0,,0,0,,0,0,,,0,0,,0,0,0,2,0,0,0,0,0
Goran DragiÄ,2010,PG,23,PHO,16,0,237,43,100,.430,13,40,.325,30,60,.500,.495,23,31,.742,10,19,29,36,4,1,16,18,122
Jared Dudley,2010,SF,24,PHO,16,0,377,40,86,.465,25,59,.424,15,27,.556,.610,17,28,.607,15,45,60,28,18,6,9,37,122
Tim Duncan*,2010,C,33,SAS,10,10,373,78,150,.520,1,2,.500,77,148,.520,.523,33,69,.478,30,69,99,26,8,17,24,27,190
Kevin Durant,2010,SF,21,OKC,6,6,231,43,123,.350,10,35,.286,33,88,.375,.390,54,62,.871,8,38,46,14,3,8,22,17,150
Maurice Evans,2010,SF,31,ATL,11,0,148,11,37,.297,3,10,.300,8,27,.296,.338,0,0,,4,9,13,2,9,0,5,19,25
Jordan Farmar,2010,PG,23,LAL,23,0,301,38,94,.404,20,50,.400,18,44,.409,.511,9,13,.692,1,26,27,32,17,0,20,30,105
Raymond Felton,2010,PG,25,CHA,4,4,130,17,42,.405,4,13,.308,13,29,.448,.452,9,12,.750,3,7,10,20,2,0,6,8,47
Rudy FernÃ¡ndez,2010,SG,24,POR,6,3,119,12,27,.444,11,23,.478,1,4,.250,.648,6,8,.750,2,8,10,8,1,0,5,7,41
Kyrylo Fesenko,2010,C,23,UTA,10,9,181,13,30,.433,0,0,,13,30,.433,.433,7,21,.333,8,31,39,12,0,5,14,30,33
Michael Finley,2010,SF,36,BOS,18,0,108,5,20,.250,3,11,.273,2,9,.222,.325,2,2,1.000,1,10,11,4,4,0,0,4,15
Derek Fisher,2010,PG,35,LAL,23,23,754,82,183,.448,27,75,.360,55,108,.509,.522,46,56,.821,9,49,58,64,28,1,36,83,237
Channing Frye,2010,C,26,PHO,16,0,435,43,118,.364,30,86,.349,13,32,.406,.492,15,16,.938,10,80,90,15,12,9,8,50,131
Dan Gadzuric,2010,C,31,MIL,7,0,76,9,17,.529,0,0,,9,17,.529,.529,1,4,.250,10,14,24,1,1,5,6,15,19
Sundiata Gaines,2010,PG,23,UTA,5,0,7,5,6,.833,1,1,1.000,4,5,.800,.917,0,2,.000,1,1,2,0,0,0,0,1,11
Kevin Garnett*,2010,PF,33,BOS,23,23,766,149,301,.495,0,2,.000,149,299,.498,.495,47,56,.839,32,138,170,58,26,20,31,74,345
Pau Gasol,2010,C,29,LAL,23,23,913,165,306,.539,0,3,.000,165,303,.545,.539,120,158,.759,92,163,255,81,9,48,44,63,450
Daniel Gibson,2010,PG,23,CLE,5,0,23,2,7,.286,1,4,.250,1,3,.333,.357,2,2,1.000,0,3,3,1,0,0,2,3,7
Taj Gibson,2010,PF,24,CHI,5,5,145,16,38,.421,0,0,,16,38,.421,.421,6,11,.545,9,26,35,3,1,3,2,17,38
Manu GinÃ³bili*,2010,SG,32,SAS,10,10,352,58,140,.414,20,60,.333,38,80,.475,.486,58,67,.866,4,33,37,60,26,2,30,30,194
Marcin Gortat,2010,C,25,ORL,14,0,212,17,26,.654,0,0,,17,26,.654,.654,8,11,.727,24,38,62,9,3,4,3,29,42
Joey Graham,2010,SF,27,DEN,4,0,29,10,17,.588,1,3,.333,9,14,.643,.618,3,5,.600,4,6,10,0,2,1,1,6,24
Stephen Graham,2010,SG,27,CHA,2,0,5,0,4,.000,0,1,.000,0,3,.000,.000,0,0,,0,0,0,1,1,0,1,1,0
Jeff Green,2010,PF,23,OKC,6,6,224,23,70,.329,8,27,.296,15,43,.349,.386,17,20,.850,6,22,28,10,4,3,6,16,71
James Harden,2010,SG,20,OKC,6,0,120,12,31,.387,6,16,.375,6,15,.400,.484,16,19,.842,1,14,15,11,6,1,3,14,46
Udonis Haslem,2010,PF,29,MIA,5,0,142,13,37,.351,0,0,,13,37,.351,.351,4,6,.667,9,28,37,4,1,1,5,18,30
Brendan Haywood,2010,C,30,DAL,6,2,139,12,21,.571,0,0,,12,21,.571,.571,12,20,.600,18,19,37,3,7,10,3,14,36
J.J. Hickson,2010,PF,21,CLE,11,0,79,14,22,.636,0,0,,14,22,.636,.636,11,16,.688,1,8,9,1,0,0,6,9,39
NenÃª,2010,C,27,DEN,5,5,169,18,29,.621,0,0,,18,29,.621,.621,21,36,.583,8,21,29,11,6,1,4,17,57
George Hill,2010,PG,23,SAS,10,8,344,46,102,.451,11,29,.379,35,73,.479,.505,31,37,.838,5,26,31,7,10,2,8,21,134
Grant Hill*,2010,SF,37,PHO,16,16,452,59,123,.480,3,16,.188,56,107,.523,.492,33,38,.868,12,81,93,36,13,10,19,46,154
Kirk Hinrich,2010,SG,29,CHI,5,5,196,22,52,.423,8,16,.500,14,36,.389,.500,10,14,.714,1,21,22,20,7,0,2,14,62
Al Horford,2010,C,23,ATL,11,11,388,67,128,.523,1,1,1.000,66,127,.520,.527,26,31,.839,28,71,99,20,8,19,15,35,161
Dwight Howard,2010,C,24,ORL,14,14,497,86,140,.614,0,0,,86,140,.614,.614,82,158,.519,38,117,155,19,11,49,51,59,254
Juwan Howard,2010,C,36,POR,6,0,87,10,19,.526,0,0,,10,19,.526,.526,0,0,,8,8,16,4,1,1,3,20,20
Larry Hughes,2010,SG,31,CHA,4,0,58,8,17,.471,4,10,.400,4,7,.571,.588,4,7,.571,1,12,13,6,0,0,3,8,24
Serge Ibaka,2010,PF,20,OKC,6,0,153,20,35,.571,0,0,,20,35,.571,.571,7,10,.700,13,26,39,2,2,12,6,19,47
Zydrunas Ilgauskas,2010,C,34,CLE,7,0,69,5,13,.385,0,0,,5,13,.385,.385,2,3,.667,7,4,11,3,0,7,1,10,12
D.J. Mbenga,2010,C,29,LAL,3,0,12,2,6,.333,0,0,,2,6,.333,.333,1,1,1.000,0,5,5,1,0,0,0,2,5
Ersan Ä°lyasova,2010,PF,22,MIL,7,0,157,24,50,.480,5,14,.357,19,36,.528,.530,15,18,.833,21,32,53,3,5,1,10,14,68
Royal Ivey,2010,SG,28,MIL,3,0,11,2,6,.333,0,2,.000,2,4,.500,.333,0,0,,0,0,0,2,0,1,1,1,4
Stephen Jackson,2010,SG,31,CHA,4,4,156,24,67,.358,3,18,.167,21,49,.429,.381,21,26,.808,6,14,20,15,5,1,17,13,72
LeBron James,2010,SF,25,CLE,11,11,460,106,211,.502,20,50,.400,86,161,.534,.550,88,120,.733,15,87,102,84,19,20,42,23,320
Antawn Jamison,2010,PF,33,CLE,11,11,375,64,137,.467,10,39,.256,54,98,.551,.504,30,41,.732,16,65,81,14,7,11,18,38,168
Othyus Jeffers,2010,SG,24,UTA,6,0,10,1,6,.167,0,0,,1,6,.167,.167,0,1,.000,1,0,1,0,0,0,1,0,2
Richard Jefferson,2010,SF,29,SAS,10,10,334,34,70,.486,1,5,.200,33,65,.508,.493,25,33,.758,8,45,53,18,6,6,15,20,94
Brandon Jennings,2010,PG,20,MIL,7,7,249,49,120,.408,12,41,.293,37,79,.468,.458,21,26,.808,5,16,21,25,8,4,8,19,131
Anthony Johnson,2010,PG,35,ORL,1,0,5,1,2,.500,0,1,.000,1,1,1.000,.500,0,0,,0,0,0,2,0,0,0,0,2
James Johnson,2010,PF,22,CHI,4,0,20,0,2,.000,0,1,.000,0,1,.000,.000,0,0,,1,0,1,1,0,0,2,11,0
Joe Johnson,2010,SG,28,ATL,11,11,440,77,199,.387,9,41,.220,68,158,.430,.410,34,42,.810,20,36,56,55,10,3,25,22,197
Dwayne Jones,2010,PF,26,PHO,2,0,10,1,2,.500,0,0,,1,2,.500,.500,3,4,.750,1,4,5,0,0,0,1,0,5
James Jones,2010,SF,29,MIA,1,0,9,0,1,.000,0,1,.000,0,0,,.000,2,2,1.000,0,0,0,0,0,0,1,1,2
Jason Kidd*,2010,PG,36,DAL,6,6,243,14,46,.304,9,28,.321,5,18,.278,.402,11,12,.917,6,35,41,42,14,1,9,15,48
Andrei Kirilenko,2010,SF,28,UTA,2,0,30,5,10,.500,0,1,.000,5,9,.556,.500,1,1,1.000,3,3,6,0,1,1,0,2,11
Kyle Korver,2010,SG,28,UTA,10,0,210,32,61,.525,11,23,.478,21,38,.553,.615,8,9,.889,0,11,11,13,5,0,7,22,83
Kosta Koufos,2010,C,20,UTA,9,0,31,4,10,.400,0,0,,4,10,.400,.400,0,0,,4,5,9,0,0,1,2,2,8
Nenad KrstiÄ,2010,C,26,OKC,6,6,129,15,37,.405,0,0,,15,37,.405,.405,13,14,.929,15,20,35,4,3,4,5,15,43
Ty Lawson,2010,PG,22,DEN,6,0,118,15,35,.429,4,10,.400,11,25,.440,.486,13,19,.684,4,4,8,16,6,0,8,18,47
Rashard Lewis,2010,PF,30,ORL,14,14,512,66,143,.462,28,75,.373,38,68,.559,.559,20,25,.800,15,64,79,32,15,10,25,38,180
Robin Lopez,2010,C,21,PHO,6,6,104,19,35,.543,0,0,,19,35,.543,.543,9,9,1.000,12,12,24,0,2,1,3,11,47
Jamaal Magloire,2010,C,31,MIA,1,0,5,0,2,.000,0,0,,0,2,.000,.000,0,0,,0,1,1,0,0,0,1,1,0
Ian Mahinmi,2010,C,23,SAS,2,0,19,3,6,.500,0,0,,3,6,.500,.500,3,4,.750,0,2,2,0,0,1,2,3,9
Shawn Marion,2010,SF,31,DAL,6,6,148,24,59,.407,0,4,.000,24,55,.436,.407,4,5,.800,7,18,25,6,1,3,8,12,52
Kenyon Martin,2010,PF,32,DEN,6,6,205,24,50,.480,0,1,.000,24,49,.490,.480,12,19,.632,14,36,50,8,9,7,11,27,60
Roger Mason,2010,SG,29,SAS,6,0,61,1,12,.083,1,7,.143,0,5,.000,.125,0,0,,0,4,4,2,1,0,2,12,3
Wesley Matthews,2010,SG,23,UTA,10,10,371,39,101,.386,15,42,.357,24,59,.407,.460,39,48,.813,10,34,44,17,18,5,15,34,132
Eric Maynor,2010,PG,22,OKC,6,0,76,6,20,.300,1,6,.167,5,14,.357,.325,9,11,.818,1,8,9,9,1,1,5,5,22
Luc Mbah a Moute,2010,PF,23,MIL,7,7,178,26,50,.520,0,2,.000,26,48,.542,.520,12,20,.600,14,25,39,5,2,0,7,15,64
Antonio McDyess,2010,PF,35,SAS,10,10,247,33,62,.532,0,0,,33,62,.532,.532,2,2,1.000,18,50,68,12,2,7,9,27,68
C.J. Miles,2010,SF,22,UTA,10,10,337,47,106,.443,15,46,.326,32,60,.533,.514,35,39,.897,5,20,25,28,6,6,19,48,144
Andre Miller,2010,PG,33,POR,6,6,210,30,74,.405,3,7,.429,27,67,.403,.426,31,40,.775,5,14,19,36,7,1,19,12,94
Brad Miller,2010,C,33,CHI,5,0,93,10,27,.370,0,4,.000,10,23,.435,.370,7,7,1.000,3,15,18,4,0,1,7,16,27
Patty Mills,2010,PG,21,POR,3,0,12,2,4,.500,1,1,1.000,1,3,.333,.625,1,1,1.000,0,0,0,3,0,0,1,1,6
Paul Millsap,2010,PF,24,UTA,10,0,323,70,122,.574,0,2,.000,70,120,.583,.574,40,58,.690,34,54,88,22,11,14,13,36,180
Nazr Mohammed,2010,C,32,CHA,4,0,48,11,19,.579,0,0,,11,19,.579,.579,2,3,.667,5,3,8,2,1,2,1,13,24
Jamario Moon,2010,SF,29,CLE,11,0,113,14,24,.583,8,16,.500,6,8,.750,.750,2,3,.667,2,14,16,5,4,5,0,8,38
Randolph Morris,2010,PF,24,ATL,3,0,10,1,2,.500,0,0,,1,2,.500,.500,1,1,1.000,1,1,2,0,0,0,0,3,3
Adam Morrison,2010,SF,25,LAL,2,0,13,4,9,.444,0,2,.000,4,7,.571,.444,0,0,,2,3,5,1,0,0,0,2,8
Byron Mullens,2010,PF,20,OKC,1,0,4,0,2,.000,0,0,,0,2,.000,.000,1,2,.500,0,0,0,0,0,0,0,0,1
Ronald Murray,2010,SG,30,CHI,5,0,97,15,37,.405,4,12,.333,11,25,.440,.459,8,8,1.000,4,9,13,10,2,0,1,3,42
Eduardo NÃ¡jera,2010,PF,33,DAL,5,0,36,2,8,.250,0,5,.000,2,3,.667,.250,0,0,,5,4,9,0,2,0,1,8,4
Steve Nash*,2010,PG,35,PHO,16,16,539,99,191,.518,19,50,.380,80,141,.567,.568,67,75,.893,6,46,52,161,4,1,60,20,284
Jameer Nelson,2010,PG,27,ORL,14,14,479,91,190,.479,33,84,.393,58,106,.547,.566,51,62,.823,9,41,50,67,14,0,35,38,266
Joakim Noah,2010,C,24,CHI,5,5,188,28,53,.528,0,0,,28,53,.528,.528,18,19,.947,20,45,65,13,9,7,15,20,74
Dirk Nowitzki,2010,PF,31,DAL,6,6,233,58,106,.547,4,7,.571,54,99,.545,.566,40,42,.952,7,42,49,18,5,4,10,15,160
Jermaine O'Neal,2010,C,31,MIA,5,5,117,9,44,.205,0,0,,9,44,.205,.205,3,7,.429,10,18,28,5,4,10,7,13,21
Shaquille O'Neal*,2010,C,37,CLE,11,11,243,48,93,.516,0,0,,48,93,.516,.516,31,47,.660,21,40,61,15,2,13,24,41,127
Lamar Odom,2010,PF,30,LAL,23,0,667,91,194,.469,10,41,.244,81,153,.529,.495,30,50,.600,60,138,198,46,15,21,28,84,222
Mehmet Okur,2010,C,30,UTA,1,1,11,2,2,1.000,1,1,1.000,1,1,1.000,1.250,2,2,1.000,1,1,2,0,0,0,1,0,7
Kevin Ollie,2010,PG,37,OKC,1,0,5,0,1,.000,0,0,,0,1,.000,.000,0,0,,0,0,0,0,0,0,0,0,0
Zaza Pachulia,2010,C,25,ATL,11,0,161,18,35,.514,0,0,,18,35,.514,.514,15,24,.625,19,19,38,3,2,7,9,34,51
Jannero Pargo,2010,PG,30,CHI,2,0,8,1,5,.200,1,2,.500,0,3,.000,.300,0,0,,0,0,0,1,0,0,0,0,3
Anthony Parker,2010,SG,34,CLE,11,11,331,30,64,.469,20,44,.455,10,20,.500,.625,11,15,.733,1,25,26,14,9,3,11,16,91
Tony Parker,2010,PG,27,SAS,10,2,335,73,154,.474,2,3,.667,71,151,.470,.481,25,42,.595,9,29,38,54,6,0,22,20,173
Kendrick Perkins,2010,C,25,BOS,23,23,575,49,96,.510,0,1,.000,49,95,.516,.510,33,55,.600,41,102,143,22,9,32,43,79,131
Johan Petro,2010,C,24,DEN,6,1,45,6,11,.545,0,0,,6,11,.545,.545,1,2,.500,2,9,11,1,1,3,3,13,13
Paul Pierce*,2010,SF,32,BOS,24,24,930,147,336,.438,40,102,.392,107,234,.457,.497,117,142,.824,20,123,143,82,24,14,64,80,451
MickaÃ«l PiÃ©trus,2010,SF,27,ORL,14,0,282,35,80,.438,28,61,.459,7,19,.368,.613,20,30,.667,2,18,20,10,9,6,6,27,118
Leon Powe,2010,SF,26,CLE,3,0,9,1,4,.250,0,0,,1,4,.250,.250,3,4,.750,1,1,2,0,0,0,1,3,5
Josh Powell,2010,PF,27,LAL,13,0,40,3,8,.375,0,1,.000,3,7,.429,.375,3,4,.750,2,4,6,1,0,0,1,9,9
Ronnie Price,2010,PG,26,UTA,10,0,90,7,24,.292,2,7,.286,5,17,.294,.333,4,8,.500,5,5,10,14,4,1,2,20,20
Theo Ratliff,2010,C,36,CHA,4,4,47,3,8,.375,0,0,,3,8,.375,.375,1,2,.500,0,3,3,1,2,0,2,15,7
J.J. Redick,2010,SG,25,ORL,14,0,269,30,71,.423,15,35,.429,15,36,.417,.528,30,35,.857,4,20,24,19,10,0,20,22,105
Chris Richard,2010,PF,25,CHI,2,0,5,0,0,,0,0,,0,0,,,0,0,,1,2,3,0,0,0,0,0,0
Jason Richardson,2010,SG,29,PHO,16,16,533,112,223,.502,48,101,.475,64,122,.525,.610,44,58,.759,18,69,87,17,17,4,10,35,316
Quentin Richardson,2010,SF,29,MIA,5,5,149,18,45,.400,9,22,.409,9,23,.391,.500,4,5,.800,1,18,19,8,8,1,5,16,49
Luke Ridnour,2010,PG,28,MIL,7,0,121,21,45,.467,5,14,.357,16,31,.516,.522,10,12,.833,4,9,13,13,4,1,10,13,57
Nate Robinson,2010,PG,25,BOS,17,0,128,24,64,.375,11,33,.333,13,31,.419,.461,12,15,.800,4,10,14,18,6,1,7,16,71
Rajon Rondo,2010,PG,23,BOS,24,24,975,151,326,.463,9,24,.375,142,302,.470,.477,68,114,.596,38,96,134,223,46,3,72,57,379
Derrick Rose,2010,PG,21,CHI,5,5,212,57,125,.456,2,6,.333,55,119,.462,.464,18,22,.818,4,13,17,36,4,0,13,8,134
Brandon Roy,2010,SG,25,POR,3,1,83,10,33,.303,2,12,.167,8,21,.381,.333,7,9,.778,2,5,7,5,0,0,3,7,29
John Salmons,2010,SG,30,MIL,7,7,285,44,109,.404,4,23,.174,40,86,.465,.422,27,28,.964,7,19,26,28,10,4,12,19,119
Brian Scalabrine,2010,PF,31,BOS,1,0,1,0,0,,0,0,,0,0,,,0,0,,0,0,0,0,0,0,0,0,0
Thabo Sefolosha,2010,SG,25,OKC,6,6,127,8,27,.296,3,13,.231,5,14,.357,.352,8,9,.889,3,15,18,7,5,6,2,15,27
J.R. Smith,2010,SG,24,DEN,6,0,159,21,57,.368,11,31,.355,10,26,.385,.465,14,16,.875,5,18,23,10,4,2,6,17,67
Joe Smith,2010,PF,34,ATL,5,0,24,0,3,.000,0,0,,0,3,.000,.000,0,0,,1,1,2,0,0,1,1,1,0
Josh Smith,2010,PF,24,ATL,11,11,392,62,129,.481,2,6,.333,60,123,.488,.488,29,44,.659,37,62,99,29,13,19,17,30,155
Jerry Stackhouse,2010,SG,35,MIL,7,0,144,14,43,.326,5,15,.333,9,28,.321,.384,18,20,.900,1,11,12,8,5,1,5,4,51
DeShawn Stevenson,2010,SG,28,DAL,2,0,6,0,3,.000,0,3,.000,0,0,,.000,0,0,,0,0,0,0,0,0,0,2,0
Amar'e Stoudemire,2010,PF,27,PHO,16,16,584,124,239,.519,0,4,.000,124,235,.528,.519,107,142,.754,46,60,106,18,11,24,40,54,355
Jeff Teague,2010,PG,21,ATL,9,0,59,7,21,.333,2,5,.400,5,16,.313,.381,0,0,,0,2,2,4,3,1,4,3,16
Garrett Temple,2010,SG,23,SAS,6,0,15,1,3,.333,1,3,.333,0,0,,.500,1,1,1.000,0,2,2,2,1,0,2,1,4
Jason Terry,2010,SG,32,DAL,6,0,174,26,69,.377,12,30,.400,14,39,.359,.464,12,16,.750,2,13,15,12,4,1,6,16,76
Etan Thomas,2010,C,31,OKC,2,0,17,5,6,.833,0,0,,5,6,.833,.833,2,2,1.000,1,3,4,0,0,0,1,1,12
Kurt Thomas,2010,C,37,MIL,7,7,199,17,35,.486,0,0,,17,35,.486,.486,4,5,.800,12,43,55,11,3,4,8,26,38
Tyrus Thomas,2010,C,23,CHA,4,0,68,15,24,.625,0,0,,15,24,.625,.625,5,6,.833,6,16,22,2,2,2,4,9,35
Anderson VarejÃ£o,2010,PF,27,CLE,11,0,255,20,48,.417,0,1,.000,20,47,.426,.417,23,31,.742,22,49,71,7,11,9,12,38,63
Sasha VujaÄiÄ,2010,SG,25,LAL,10,0,76,10,23,.435,6,15,.400,4,8,.500,.565,5,6,.833,3,5,8,5,2,0,3,8,31
Dwyane Wade,2010,SG,28,MIA,5,5,210,62,110,.564,15,37,.405,47,73,.644,.632,27,40,.675,6,22,28,34,8,8,26,16,166
Gerald Wallace,2010,SF,27,CHA,4,4,164,21,44,.477,5,11,.455,16,33,.485,.534,23,35,.657,2,34,36,9,5,6,3,9,70
Rasheed Wallace,2010,C,35,BOS,24,1,410,52,125,.416,19,55,.345,33,70,.471,.492,24,29,.828,5,66,71,9,10,14,9,82,147
Luke Walton,2010,SF,29,LAL,16,0,96,7,23,.304,2,9,.222,5,14,.357,.348,2,4,.500,0,8,8,14,1,2,4,13,18
Hakim Warrick,2010,PF,27,CHI,3,0,31,2,11,.182,0,1,.000,2,10,.200,.182,5,6,.833,3,2,5,0,0,0,2,3,9
Kyle Weaver,2010,SG,23,OKC,1,0,12,1,4,.250,0,1,.000,1,3,.333,.250,0,0,,0,2,2,2,0,0,0,2,2
Martell Webster,2010,SF,23,POR,6,0,152,22,52,.423,5,17,.294,17,35,.486,.471,10,18,.556,7,19,26,4,5,3,3,13,59
Delonte West,2010,SG,26,CLE,11,0,269,28,67,.418,3,19,.158,25,48,.521,.440,15,16,.938,6,15,21,29,9,3,19,16,74
Mario West,2010,SG,25,ATL,7,0,20,3,4,.750,0,1,.000,3,3,1.000,.750,0,0,,1,1,2,1,1,0,0,7,6
Russell Westbrook,2010,PG,21,OKC,6,6,212,43,91,.473,5,12,.417,38,79,.481,.500,32,38,.842,10,26,36,36,10,1,14,13,123
Deron Williams,2010,PG,25,UTA,10,10,398,67,149,.450,20,51,.392,47,98,.480,.517,89,111,.802,4,23,27,102,10,4,30,37,243
Jason Williams,2010,PG,34,ORL,14,0,192,13,38,.342,6,24,.250,7,14,.500,.421,5,5,1.000,3,8,11,23,4,0,5,8,37
Jawad Williams,2010,PG,26,CLE,3,0,4,0,2,.000,0,2,.000,0,0,,.000,0,0,,0,0,0,0,0,0,0,1,0
Marvin Williams,2010,SF,23,ATL,11,11,345,31,79,.392,1,2,.500,30,77,.390,.399,29,32,.906,23,40,63,8,6,5,5,20,92
Mo Williams,2010,PG,27,CLE,11,11,411,52,127,.409,17,52,.327,35,75,.467,.476,37,46,.804,3,31,34,59,6,2,23,35,158
Shelden Williams,2010,PF,26,BOS,8,0,57,4,9,.444,0,0,,4,9,.444,.444,5,6,.833,2,11,13,0,1,0,6,8,13
Metta World Peace,2010,SF,30,LAL,23,23,839,101,254,.398,34,117,.291,67,137,.489,.465,22,38,.579,33,58,91,49,35,12,25,67,258
Dorell Wright,2010,SF,24,MIA,5,0,112,9,25,.360,2,8,.250,7,17,.412,.400,5,5,1.000,2,17,19,9,2,0,6,3,25
Arron Afflalo,2011,SG,25,DEN,3,3,85,12,34,.353,3,12,.250,9,22,.409,.397,7,8,.875,0,9,9,7,0,0,3,10,34
LaMarcus Aldridge,2011,PF,25,POR,6,6,258,53,115,.461,0,0,,53,115,.461,.461,19,24,.792,16,29,45,8,8,10,9,19,125
Malik Allen,2011,PF,32,ORL,1,0,7,0,1,.000,0,0,,0,1,.000,.000,1,2,.500,0,1,1,0,0,0,0,2,1
Ray Allen*,2011,SG,35,BOS,9,9,361,57,109,.523,32,56,.571,25,53,.472,.670,24,25,.960,5,29,34,22,11,1,10,21,170
Tony Allen,2011,SG,29,MEM,13,13,350,43,101,.426,1,7,.143,42,94,.447,.431,27,41,.659,15,23,38,20,25,5,24,43,114
Chris Andersen,2011,C,32,DEN,5,0,73,7,11,.636,0,0,,7,11,.636,.636,10,14,.714,5,9,14,3,3,7,3,8,24
Ryan Anderson,2011,PF,22,ORL,6,0,147,8,30,.267,6,20,.300,2,10,.200,.367,6,6,1.000,10,17,27,3,5,1,1,16,28
Carmelo Anthony,2011,SF,26,NYK,4,4,156,33,88,.375,9,26,.346,24,62,.387,.426,29,34,.853,13,28,41,19,5,3,13,16,104
Joel Anthony,2011,C,28,MIA,21,13,575,18,49,.367,0,0,,18,49,.367,.367,22,31,.710,35,62,97,10,8,38,13,54,58
Gilbert Arenas,2011,PG,29,ORL,5,0,81,18,42,.429,3,12,.250,15,30,.500,.464,4,6,.667,4,10,14,12,1,1,6,14,43
Trevor Ariza,2011,SF,25,NOH,6,6,241,35,85,.412,7,21,.333,28,64,.438,.453,16,22,.727,7,32,39,20,8,3,7,16,93
Hilton Armstrong,2011,C,26,ATL,8,0,35,1,5,.200,0,0,,1,5,.200,.200,3,6,.500,4,6,10,1,3,0,2,7,5
Darrell Arthur,2011,PF,22,MEM,13,0,201,39,85,.459,1,1,1.000,38,84,.452,.465,13,17,.765,14,15,29,7,7,12,12,30,92
Ãmer AÅÄ±k,2011,C,24,CHI,15,0,148,6,13,.462,0,0,,6,13,.462,.462,3,10,.300,10,21,31,1,2,8,7,21,15
J.J. Barea,2011,PG,26,DAL,21,3,390,72,172,.419,16,50,.320,56,122,.459,.465,27,34,.794,8,31,39,71,6,0,23,28,187
Matt Barnes,2011,SF,30,LAL,10,0,131,15,38,.395,2,12,.167,13,26,.500,.421,4,7,.571,11,17,28,5,7,2,6,23,36
Earl Barron,2011,C,29,POR,1,0,0,0,0,,0,0,,0,0,,,0,0,,0,0,0,0,0,0,0,0,0
Brandon Bass,2011,PF,25,ORL,6,6,139,16,38,.421,0,0,,16,38,.421,.421,12,13,.923,12,13,25,2,3,5,7,7,44
Tony Battie,2011,C,34,PHI,5,0,38,3,7,.429,0,0,,3,7,.429,.429,1,2,.500,2,8,10,0,0,3,1,5,7
Shane Battier,2011,SF,32,MEM,13,0,339,29,66,.439,8,29,.276,21,37,.568,.500,6,9,.667,17,35,52,15,7,6,6,27,72
Nicolas Batum,2011,SF,22,POR,6,0,151,19,46,.413,7,26,.269,12,20,.600,.489,3,4,.750,1,9,10,8,5,5,7,14,48
Marco Belinelli,2011,SG,24,NOH,6,6,173,23,63,.365,8,26,.308,15,37,.405,.429,4,4,1.000,0,5,5,4,5,0,4,12,58
Mike Bibby,2011,PG,32,MIA,20,20,415,27,96,.281,17,66,.258,10,30,.333,.370,2,4,.500,5,31,36,23,11,6,17,30,73
Chauncey Billups,2011,PG,34,NYK,1,1,35,3,11,.273,2,6,.333,1,5,.200,.364,2,2,1.000,0,2,2,4,0,0,3,2,10
DeJuan Blair,2011,PF,21,SAS,4,0,50,7,21,.333,0,0,,7,21,.333,.333,3,5,.600,9,4,13,2,0,1,2,6,17
Steve Blake,2011,PG,30,LAL,9,0,145,7,23,.304,6,18,.333,1,5,.200,.435,0,0,,1,13,14,20,5,0,5,8,20
Keith Bogans,2011,SG,30,CHI,16,16,307,28,69,.406,25,59,.424,3,10,.300,.587,1,4,.250,4,16,20,12,10,3,7,26,82
Matt Bonner,2011,PF,30,SAS,6,0,123,12,25,.480,6,18,.333,6,7,.857,.600,8,10,.800,7,12,19,2,1,1,1,18,38
Carlos Boozer,2011,C,29,CHI,16,16,507,77,178,.433,0,1,.000,77,177,.435,.433,48,60,.800,40,115,155,28,9,7,28,49,202
Chris Bosh*,2011,PF,26,MIA,21,21,834,138,291,.474,0,4,.000,138,287,.481,.474,114,140,.814,47,131,178,23,14,19,40,48,390
Elton Brand,2011,PF,31,PHI,5,5,185,34,62,.548,0,0,,34,62,.548,.548,10,13,.769,12,30,42,3,2,6,4,21,78
Corey Brewer,2011,SG,24,DAL,6,0,23,4,9,.444,1,3,.333,3,6,.500,.500,0,0,,0,2,2,1,4,0,2,5,9
Ronnie Brewer,2011,SG,25,CHI,16,0,260,24,50,.480,3,7,.429,21,43,.488,.510,13,17,.765,7,27,34,15,12,6,4,14,64
Shannon Brown,2011,SG,25,LAL,10,0,166,28,61,.459,7,25,.280,21,36,.583,.516,9,14,.643,5,14,19,7,6,2,9,10,72
Kobe Bryant*,2011,SG,32,LAL,10,10,354,83,186,.446,12,41,.293,71,145,.490,.478,50,61,.820,8,26,34,33,16,3,31,23,228
Rasual Butler,2011,SG,31,CHI,3,0,7,1,1,1.000,1,1,1.000,0,0,,1.500,0,0,,0,1,1,0,0,0,0,0,3
Andrew Bynum,2011,C,23,LAL,10,10,320,57,105,.543,0,0,,57,105,.543,.543,30,36,.833,36,60,96,8,5,14,20,33,144
Marcus Camby,2011,C,36,POR,6,6,167,10,22,.455,1,1,1.000,9,21,.429,.477,0,2,.000,18,40,58,8,4,9,5,18,21
Brian Cardinal,2011,SF,33,DAL,9,0,37,3,4,.750,3,4,.750,0,0,,1.125,1,2,.500,0,3,3,2,1,0,3,8,10
Anthony Carter,2011,PG,35,NYK,4,0,49,8,15,.533,1,3,.333,7,12,.583,.567,2,2,1.000,2,6,8,6,2,1,4,1,19
Mario Chalmers,2011,PG,24,MIA,21,1,511,54,124,.435,32,84,.381,22,40,.550,.565,23,32,.719,4,36,40,44,27,1,28,48,163
Tyson Chandler,2011,C,28,DAL,21,21,680,57,98,.582,0,0,,57,98,.582,.582,53,78,.679,79,114,193,8,13,19,14,77,167
Wilson Chandler,2011,SF,23,DEN,5,2,115,8,29,.276,1,7,.143,7,22,.318,.293,7,9,.778,2,20,22,2,3,4,4,15,24
Earl Clark,2011,SF,23,ORL,1,0,6,1,3,.333,0,0,,1,3,.333,.333,0,0,,2,2,4,1,1,1,0,0,2
Jason Collins,2011,C,32,ATL,12,9,158,9,14,.643,0,0,,9,14,.643,.643,3,8,.375,6,11,17,1,5,3,5,31,21
Darren Collison,2011,PG,23,IND,5,5,146,18,46,.391,4,6,.667,14,40,.350,.435,7,11,.636,4,9,13,20,5,2,9,7,47
Nick Collison,2011,C,30,OKC,17,0,413,48,76,.632,0,0,,48,76,.632,.632,18,23,.783,47,51,98,15,15,15,13,63,114
Mike Conley,2011,PG,23,MEM,13,13,507,71,183,.388,11,37,.297,60,146,.411,.418,44,53,.830,7,43,50,83,14,3,30,39,197
Daequan Cook,2011,SG,23,OKC,17,0,195,22,56,.393,16,46,.348,6,10,.600,.536,4,4,1.000,1,26,27,1,3,0,7,17,64
Jamal Crawford,2011,SG,30,ATL,12,0,358,61,155,.394,21,60,.350,40,95,.421,.461,42,51,.824,1,15,16,30,9,4,16,17,185
Glen Davis,2011,C,25,BOS,9,0,191,18,46,.391,0,1,.000,18,45,.400,.391,8,11,.727,7,25,32,8,3,0,9,21,44
Luol Deng,2011,SF,25,CHI,16,16,687,98,230,.426,22,68,.324,76,162,.469,.474,52,62,.839,27,79,106,43,24,10,26,40,270
Toney Douglas,2011,SG,24,NYK,4,3,112,15,41,.366,7,18,.389,8,23,.348,.451,6,6,1.000,2,11,13,9,2,0,4,12,43
Chris Duhon,2011,PG,28,ORL,1,0,4,1,2,.500,1,2,.500,0,0,,.750,2,2,1.000,0,0,0,0,0,0,0,0,5
Tim Duncan*,2011,C,34,SAS,6,6,212,33,69,.478,0,0,,33,69,.478,.478,10,16,.625,16,47,63,16,3,15,18,17,76
Mike Dunleavy,2011,SG,30,IND,5,0,72,7,20,.350,3,10,.300,4,10,.400,.425,8,12,.667,0,6,6,8,4,0,1,3,25
Kevin Durant,2011,SF,22,OKC,17,17,722,155,345,.449,37,109,.339,118,236,.500,.503,140,167,.838,18,121,139,48,16,19,42,52,487
Patrick Ewing,2011,SF,26,NOH,2,0,2,1,1,1.000,1,1,1.000,0,0,,1.500,0,0,,0,0,0,0,0,0,0,0,3
Raymond Felton,2011,SG,26,DEN,5,0,152,18,50,.360,4,16,.250,14,34,.412,.400,18,24,.750,0,9,9,21,6,0,10,10,58
Rudy FernÃ¡ndez,2011,SG,25,POR,6,0,81,4,18,.222,3,10,.300,1,8,.125,.306,6,9,.667,2,10,12,5,2,1,2,7,17
Landry Fields,2011,SG,22,NYK,4,4,71,3,15,.200,0,4,.000,3,11,.273,.200,1,6,.167,1,4,5,5,2,3,4,0,7
Derek Fisher,2011,PG,36,LAL,10,10,325,29,67,.433,7,17,.412,22,50,.440,.485,17,21,.810,1,26,27,36,14,2,8,25,82
Gary Forbes,2011,SF,25,DEN,1,0,2,0,1,.000,0,0,,0,1,.000,.000,0,0,,0,1,1,0,0,0,0,0,0
T.J. Ford,2011,PG,27,IND,2,0,14,3,3,1.000,1,1,1.000,2,2,1.000,1.167,0,0,,0,1,1,2,0,0,2,0,7
Jeff Foster,2011,C,34,IND,5,0,93,7,12,.583,0,0,,7,12,.583,.583,3,8,.375,10,14,24,4,2,4,5,14,17
Danilo Gallinari,2011,SF,22,DEN,5,5,148,19,44,.432,7,15,.467,12,29,.414,.511,15,21,.714,1,16,17,10,4,0,7,17,60
Kevin Garnett*,2011,PF,34,BOS,9,9,328,56,127,.441,0,1,.000,56,126,.444,.441,22,29,.759,21,77,98,23,17,9,19,27,134
Marc Gasol,2011,C,26,MEM,13,13,519,72,141,.511,0,2,.000,72,139,.518,.511,51,73,.699,41,105,146,29,14,28,26,44,195
Pau Gasol,2011,C,30,LAL,10,10,358,47,112,.420,1,2,.500,46,110,.418,.424,36,45,.800,32,46,78,38,4,17,17,33,131
Paul George,2011,SG,20,IND,5,5,133,10,33,.303,3,13,.231,7,20,.350,.348,7,8,.875,5,20,25,5,7,10,7,11,30
Taj Gibson,2011,PF,25,CHI,16,0,284,43,76,.566,0,1,.000,43,75,.573,.566,9,15,.600,26,40,66,9,5,22,14,32,95
Manu GinÃ³bili*,2011,SG,33,SAS,5,5,174,31,70,.443,9,28,.321,22,42,.524,.507,32,41,.780,2,18,20,21,13,3,17,13,103
Danny Granger,2011,SF,27,IND,5,5,183,43,90,.478,8,23,.348,35,67,.522,.522,14,16,.875,6,22,28,16,6,1,7,12,108
Aaron Gray,2011,C,26,NOH,6,0,87,9,13,.692,0,0,,9,13,.692,.692,3,8,.375,3,18,21,2,2,2,5,13,21
Danny Green,2011,SG,23,SAS,4,0,7,2,6,.333,1,4,.250,1,2,.500,.417,0,0,,0,1,1,2,1,1,1,1,5
Jeff Green,2011,SF,24,BOS,9,0,173,23,53,.434,7,16,.438,16,37,.432,.500,13,18,.722,6,18,24,2,5,4,12,20,66
Willie Green,2011,SG,29,NOH,6,0,84,14,36,.389,2,9,.222,12,27,.444,.417,4,7,.571,1,4,5,4,2,0,3,14,34
Hamed Haddadi,2011,C,25,MEM,9,0,31,3,10,.300,0,1,.000,3,9,.333,.300,5,6,.833,3,5,8,0,0,5,2,7,11
Tyler Hansbrough,2011,PF,25,IND,5,5,164,20,60,.333,0,0,,20,60,.333,.333,16,18,.889,13,14,27,5,6,0,9,13,56
James Harden,2011,SG,21,OKC,17,0,537,66,139,.475,23,76,.303,43,63,.683,.558,66,80,.825,10,81,91,61,21,13,28,48,221
Al Harrington,2011,PF,30,DEN,5,0,70,10,22,.455,5,10,.500,5,12,.417,.568,3,4,.750,1,6,7,5,3,0,4,7,28
Udonis Haslem,2011,PF,30,MIA,12,0,290,27,68,.397,0,0,,27,68,.397,.397,9,10,.900,13,41,54,9,6,4,11,31,63
Spencer Hawes,2011,C,22,PHI,5,5,98,12,33,.364,0,1,.000,12,32,.375,.364,2,4,.500,5,14,19,9,0,2,2,11,26
Brendan Haywood,2011,C,31,DAL,18,0,275,18,31,.581,0,0,,18,31,.581,.581,20,43,.465,34,39,73,4,2,18,13,48,56
Roy Hibbert,2011,C,24,IND,5,5,132,20,45,.444,0,0,,20,45,.444,.444,12,17,.706,15,19,34,3,2,9,13,21,52
NenÃª,2011,C,28,DEN,5,5,162,22,46,.478,0,0,,22,46,.478,.478,27,48,.563,14,31,45,8,5,4,8,17,71
George Hill,2011,PG,24,SAS,6,1,189,20,50,.400,4,15,.267,16,35,.457,.440,26,30,.867,5,25,30,14,9,2,8,15,70
Kirk Hinrich,2011,PG,30,ATL,6,6,173,26,52,.500,8,19,.421,18,33,.545,.577,1,1,1.000,1,13,14,16,7,2,4,21,61
Jrue Holiday,2011,PG,20,PHI,5,5,188,24,58,.414,11,21,.524,13,37,.351,.509,12,15,.800,3,16,19,28,10,2,11,10,71
Al Horford,2011,C,24,ATL,12,12,468,58,137,.423,0,2,.000,58,135,.430,.423,20,26,.769,25,90,115,42,5,12,17,33,136
Eddie House,2011,SG,32,MIA,7,0,48,4,17,.235,3,10,.300,1,7,.143,.324,0,0,,1,4,5,1,4,0,4,6,11
Dwight Howard,2011,C,25,ORL,6,6,258,51,81,.630,0,1,.000,51,80,.638,.630,60,88,.682,27,66,93,3,4,11,33,25,162
Juwan Howard,2011,PF,37,MIA,11,0,60,4,9,.444,0,0,,4,9,.444,.444,9,13,.692,3,7,10,1,0,0,2,8,17
Serge Ibaka,2011,PF,21,OKC,17,17,490,67,145,.462,0,1,.000,67,144,.465,.462,33,40,.825,47,77,124,3,4,52,21,64,167
Andre Iguodala,2011,SF,27,PHI,5,5,182,22,52,.423,3,14,.214,19,38,.500,.452,10,14,.714,7,28,35,34,5,2,14,16,57
Zydrunas Ilgauskas,2011,C,35,MIA,9,8,104,14,30,.467,0,0,,14,30,.467,.467,4,6,.667,15,17,32,3,0,3,9,16,32
D.J. Mbenga,2011,C,30,NOH,5,0,26,2,2,1.000,0,0,,2,2,1.000,1.000,1,2,.500,2,3,5,1,2,3,1,7,5
Royal Ivey,2011,SG,29,OKC,2,0,6,2,2,1.000,2,2,1.000,0,0,,1.500,0,0,,0,1,1,1,0,0,0,0,6
Jarrett Jack,2011,SG,27,NOH,6,0,111,12,34,.353,0,5,.000,12,29,.414,.353,11,16,.688,1,14,15,13,1,1,8,4,35
LeBron James,2011,SF,26,MIA,21,21,922,174,373,.466,30,85,.353,144,288,.500,.507,119,156,.763,34,142,176,123,35,25,66,56,497
Richard Jefferson,2011,SF,30,SAS,6,6,176,12,31,.387,6,17,.353,6,14,.429,.484,9,11,.818,2,23,25,5,3,3,6,13,39
Jared Jeffries,2011,PF,29,NYK,4,0,85,11,23,.478,0,0,,11,23,.478,.478,3,4,.750,13,7,20,1,3,7,3,7,25
Armon Johnson,2011,PG,21,POR,2,0,0,0,0,,0,0,,0,0,,,0,0,,0,1,1,0,0,0,0,0,0
Chris Johnson,2011,C,25,POR,4,0,19,1,1,1.000,0,0,,1,1,1.000,1.000,2,2,1.000,0,5,5,0,0,2,0,3,4
Joe Johnson,2011,SG,29,ATL,12,12,497,87,198,.439,18,42,.429,69,156,.442,.485,34,42,.810,18,37,55,40,13,1,31,19,226
Trey Johnson,2011,SG,26,LAL,3,0,12,1,5,.200,0,1,.000,1,4,.250,.200,1,2,.500,1,3,4,1,0,0,0,2,3
Dahntay Jones,2011,SG,30,IND,3,0,50,9,20,.450,0,3,.000,9,17,.529,.450,8,9,.889,2,0,2,2,1,0,3,7,26
James Jones,2011,SF,30,MIA,12,0,272,24,51,.471,17,37,.459,7,14,.500,.637,13,13,1.000,3,27,30,2,6,2,4,24,78
Jason Kidd*,2011,PG,37,DAL,21,21,744,64,161,.398,43,115,.374,21,46,.457,.531,24,30,.800,11,84,95,153,40,10,56,36,195
Kyle Korver,2011,SG,29,CHI,16,0,276,38,98,.388,22,52,.423,16,46,.348,.500,7,7,1.000,1,18,19,17,8,3,16,35,105
Kosta Koufos,2011,C,21,DEN,1,0,2,1,1,1.000,0,0,,1,1,1.000,1.000,0,0,,0,0,0,0,0,0,0,0,2
Nenad KrstiÄ,2011,C,27,BOS,7,0,56,5,8,.625,0,0,,5,8,.625,.625,2,3,.667,5,7,12,2,0,4,3,8,12
Carl Landry,2011,PF,27,NOH,6,6,213,31,68,.456,0,0,,31,68,.456,.456,33,36,.917,11,19,30,6,4,3,12,25,95
Ty Lawson,2011,PG,23,DEN,5,5,167,26,52,.500,5,11,.455,21,41,.512,.548,21,23,.913,7,10,17,19,5,1,6,9,78
Jamaal Magloire,2011,C,32,MIA,3,0,18,2,5,.400,0,0,,2,5,.400,.400,0,0,,1,4,5,2,1,0,1,4,4
Ian Mahinmi,2011,C,24,DAL,6,0,33,3,5,.600,0,0,,3,5,.600,.600,5,9,.556,3,3,6,0,1,0,0,16,11
Shawn Marion,2011,SF,32,DAL,21,21,690,105,225,.467,0,5,.000,105,220,.477,.467,40,47,.851,46,87,133,45,21,19,36,53,250
Kenyon Martin,2011,PF,33,DEN,5,5,148,24,50,.480,0,0,,24,50,.480,.480,11,18,.611,6,33,39,8,2,2,7,18,59
Roger Mason,2011,SG,30,NYK,3,0,55,7,18,.389,5,13,.385,2,5,.400,.528,0,0,,3,1,4,3,1,0,1,6,19
Wesley Matthews,2011,SG,24,POR,6,6,202,27,57,.474,8,21,.381,19,36,.528,.544,16,19,.842,2,5,7,6,4,1,7,15,78
Eric Maynor,2011,PG,23,OKC,17,0,220,29,77,.377,9,25,.360,20,52,.385,.435,15,19,.789,5,17,22,37,9,0,16,16,82
O.J. Mayo,2011,SG,23,MEM,13,2,362,52,134,.388,20,49,.408,32,85,.376,.463,23,29,.793,10,31,41,31,11,4,17,42,147
Antonio McDyess,2011,PF,36,SAS,6,6,145,15,36,.417,0,0,,15,36,.417,.417,4,7,.571,10,20,30,8,2,5,7,21,34
Josh McRoberts,2011,PF,23,IND,5,0,79,8,24,.333,0,1,.000,8,23,.348,.333,9,11,.818,8,10,18,6,4,1,5,17,25
Jodie Meeks,2011,SG,23,PHI,5,5,125,13,31,.419,8,18,.444,5,13,.385,.548,5,6,.833,2,8,10,4,3,0,2,6,39
Andre Miller,2011,PG,34,POR,6,6,194,33,67,.493,4,10,.400,29,57,.509,.522,19,24,.792,5,14,19,33,2,0,13,17,89
Mike Miller,2011,SG,30,MIA,18,0,215,18,53,.340,11,37,.297,7,16,.438,.443,0,0,,9,40,49,13,7,1,8,26,47
Patty Mills,2011,PG,22,POR,2,0,5,0,2,.000,0,1,.000,0,1,.000,.000,0,0,,0,1,1,0,0,0,1,0,0
Nazr Mohammed,2011,C,33,OKC,14,0,148,14,34,.412,0,0,,14,34,.412,.412,4,10,.400,9,23,32,0,4,6,6,27,32
Troy Murphy,2011,PF,30,BOS,1,0,3,0,0,,0,0,,0,0,,,0,0,,1,0,1,0,0,0,0,0,0
Gary Neal,2011,SG,26,SAS,6,0,111,17,46,.370,5,19,.263,12,27,.444,.424,7,7,1.000,2,16,18,5,1,1,2,11,46
Jameer Nelson,2011,PG,28,ORL,6,6,216,31,82,.378,6,26,.231,25,56,.446,.415,11,14,.786,7,18,25,30,12,0,8,14,79
Joakim Noah,2011,C,25,CHI,16,16,529,51,124,.411,0,0,,51,124,.411,.411,37,51,.725,68,95,163,40,16,33,19,63,139
AndrÃ©s Nocioni,2011,SF,31,PHI,1,0,10,0,3,.000,0,2,.000,0,1,.000,.000,0,0,,0,2,2,0,0,0,1,1,0
Steve Novak,2011,SF,27,SAS,1,0,6,0,0,,0,0,,0,0,,,0,0,,0,1,1,0,0,0,0,0,0
Dirk Nowitzki,2011,PF,32,DAL,21,21,826,192,396,.485,23,50,.460,169,346,.488,.514,175,186,.941,12,159,171,53,12,13,65,46,582
Jermaine O'Neal,2011,C,32,BOS,9,9,197,21,43,.488,0,0,,21,43,.488,.488,10,11,.909,15,23,38,8,2,16,8,34,52
Shaquille O'Neal*,2011,C,38,BOS,2,0,12,1,2,.500,0,0,,1,2,.500,.500,0,2,.000,0,0,0,1,1,0,0,4,2
Lamar Odom,2011,PF,31,LAL,10,1,286,45,98,.459,4,20,.200,41,78,.526,.480,27,38,.711,13,52,65,21,2,4,15,25,121
Emeka Okafor,2011,C,28,NOH,6,6,188,20,31,.645,0,0,,20,31,.645,.645,4,11,.364,17,16,33,0,6,6,12,28,44
Zaza Pachulia,2011,C,26,ATL,11,0,195,11,23,.478,0,0,,11,23,.478,.478,17,22,.773,17,37,54,13,2,1,9,37,39
Tony Parker,2011,PG,28,SAS,6,6,221,43,93,.462,1,8,.125,42,85,.494,.468,31,41,.756,1,15,16,31,8,2,20,10,118
Chris Paul,2011,PG,25,NOH,6,6,250,42,77,.545,9,19,.474,33,58,.569,.604,39,49,.796,3,37,40,69,11,0,22,11,132
Kendrick Perkins,2011,C,26,OKC,17,17,479,29,64,.453,0,0,,29,64,.453,.453,19,33,.576,37,66,103,13,4,13,27,57,77
Paul Pierce*,2011,SF,33,BOS,9,9,343,68,148,.459,21,47,.447,47,101,.465,.530,30,34,.882,5,40,45,25,12,4,24,30,187
Quincy Pondexter,2011,SF,22,NOH,3,0,9,1,6,.167,0,3,.000,1,3,.333,.167,0,0,,0,1,1,1,0,0,0,1,2
Leon Powe,2011,C,27,MEM,4,0,14,2,8,.250,0,0,,2,8,.250,.250,3,4,.750,2,2,4,0,0,0,0,0,7
Josh Powell,2011,PF,28,ATL,9,0,48,5,9,.556,0,0,,5,9,.556,.556,0,0,,3,6,9,1,0,0,2,8,10
A.J. Price,2011,PG,24,IND,5,0,80,13,35,.371,7,16,.438,6,19,.316,.471,9,10,.900,2,5,7,6,3,0,7,5,42
Zach Randolph,2011,PF,29,MEM,13,13,515,100,224,.446,2,8,.250,98,216,.454,.451,87,106,.821,43,98,141,31,14,10,27,45,289
Theo Ratliff,2011,C,37,LAL,1,0,1,0,0,,0,0,,0,0,,,0,0,,0,1,1,0,0,0,0,0,0
J.J. Redick,2011,SG,26,ORL,6,0,120,15,42,.357,1,15,.067,14,27,.519,.369,9,12,.750,0,11,11,6,1,1,7,8,40
Jason Richardson,2011,SG,30,ORL,5,5,153,17,51,.333,8,25,.320,9,26,.346,.412,8,8,1.000,5,15,20,6,3,2,3,16,50
Quentin Richardson,2011,SF,30,ORL,6,1,98,8,15,.533,5,10,.500,3,5,.600,.700,2,2,1.000,3,12,15,2,1,1,2,9,23
Nate Robinson,2011,PG,26,OKC,3,0,12,2,7,.286,2,6,.333,0,1,.000,.429,2,2,1.000,0,0,0,1,0,0,0,1,8
Rajon Rondo,2011,PG,24,BOS,9,9,345,51,107,.477,0,3,.000,51,104,.490,.477,24,38,.632,11,38,49,86,10,0,33,16,126
Derrick Rose,2011,PG,22,CHI,16,16,649,149,376,.396,25,101,.248,124,275,.451,.430,111,134,.828,20,49,69,123,22,11,59,33,434
Brandon Roy,2011,SG,26,POR,6,0,138,22,44,.500,4,14,.286,18,30,.600,.545,8,13,.615,2,11,13,17,1,0,4,13,56
Brandon Rush,2011,SG,25,IND,5,0,55,6,13,.462,3,4,.750,3,9,.333,.577,1,2,.500,0,7,7,3,1,1,1,5,16
Thabo Sefolosha,2011,SG,26,OKC,17,17,344,31,67,.463,4,26,.154,27,41,.659,.493,13,13,1.000,12,41,53,12,16,5,15,24,79
Ish Smith,2011,PG,22,MEM,5,0,10,2,3,.667,0,0,,2,3,.667,.667,0,0,,0,2,2,2,1,0,1,1,4
J.R. Smith,2011,SF,25,DEN,5,0,76,16,45,.356,9,21,.429,7,24,.292,.456,8,11,.727,1,9,10,5,2,0,8,8,49
Jason Smith,2011,C,24,NOH,6,0,58,7,15,.467,0,0,,7,15,.467,.467,0,0,,1,6,7,1,2,0,0,11,14
Joe Smith,2011,PF,35,LAL,5,0,11,0,2,.000,0,0,,0,2,.000,.000,0,0,,1,0,1,0,0,0,0,1,0
Josh Smith,2011,PF,25,ATL,12,12,438,69,171,.404,3,24,.125,66,147,.449,.412,40,67,.597,18,84,102,35,13,25,26,39,181
Marreese Speights,2011,C,23,PHI,2,0,21,2,12,.167,0,0,,2,12,.167,.167,0,0,,1,5,6,1,0,1,0,4,4
Tiago Splitter,2011,C,26,SAS,3,0,50,10,16,.625,0,0,,10,16,.625,.625,0,3,.000,7,7,14,1,3,1,2,4,20
DeShawn Stevenson,2011,SG,29,DAL,21,18,332,29,83,.349,27,68,.397,2,15,.133,.512,9,12,.750,1,18,19,12,11,2,10,40,94
Peja StojakoviÄ,2011,SF,33,DAL,19,0,350,49,120,.408,29,77,.377,20,43,.465,.529,7,9,.778,3,29,32,7,12,2,9,21,134
Amar'e Stoudemire,2011,C,28,NYK,4,4,134,21,55,.382,0,0,,21,55,.382,.382,16,24,.667,11,20,31,7,1,3,12,10,58
Pape Sy,2011,SF,22,ATL,4,0,11,2,3,.667,0,0,,2,3,.667,.667,2,4,.500,1,0,1,3,1,0,1,1,6
Jeff Teague,2011,PG,22,ATL,8,6,238,37,72,.514,1,7,.143,36,65,.554,.521,19,23,.826,0,17,17,28,6,3,8,10,94
Jason Terry,2011,SG,33,DAL,21,0,684,128,268,.478,42,95,.442,86,173,.497,.556,70,83,.843,6,34,40,67,26,3,32,44,368
Etan Thomas,2011,C,32,ATL,1,0,7,0,2,.000,0,0,,0,2,.000,.000,0,0,,1,0,1,0,0,0,0,1,0
Kurt Thomas,2011,PF,38,CHI,7,0,74,10,18,.556,0,2,.000,10,16,.625,.556,0,0,,9,10,19,3,1,3,3,12,20
Ronny Turiaf,2011,C,28,NYK,4,4,75,8,12,.667,0,0,,8,12,.667,.667,7,10,.700,4,7,11,4,1,6,3,4,23
Hedo TÃ¼rkoÄlu,2011,SF,31,ORL,6,6,209,20,68,.294,7,30,.233,13,38,.342,.346,8,14,.571,1,18,19,22,8,1,7,18,55
Evan Turner,2011,SG,22,PHI,5,0,97,17,38,.447,4,5,.800,13,33,.394,.500,2,2,1.000,4,19,23,4,3,1,0,9,40
Greivis VÃ¡squez,2011,PG,24,MEM,13,0,142,21,41,.512,4,11,.364,17,30,.567,.561,10,13,.769,3,16,19,25,5,2,9,11,56
Dwyane Wade,2011,SG,29,MIA,21,21,828,181,373,.485,14,52,.269,167,321,.520,.504,139,179,.777,43,107,150,92,34,28,64,53,515
Von Wafer,2011,SG,25,BOS,3,0,5,0,2,.000,0,1,.000,0,1,.000,.000,0,0,,0,1,1,0,0,0,0,0,0
Henry Walker,2011,SG,23,NYK,4,0,89,9,30,.300,3,11,.273,6,19,.316,.350,2,3,.667,5,8,13,4,5,0,7,9,23
Gerald Wallace,2011,PF,28,POR,6,6,226,30,67,.448,3,17,.176,27,50,.540,.470,28,32,.875,9,46,55,17,8,3,15,19,91
Luke Walton,2011,SF,30,LAL,1,0,4,0,2,.000,0,2,.000,0,0,,.000,0,0,,0,1,1,0,0,0,2,0,0
C.J. Watson,2011,PG,26,CHI,16,0,136,19,56,.339,3,15,.200,16,41,.390,.366,10,11,.909,2,12,14,31,8,0,17,15,51
Delonte West,2011,PG,27,BOS,9,0,170,22,47,.468,7,19,.368,15,28,.536,.543,8,10,.800,4,13,17,12,5,0,12,16,59
Russell Westbrook,2011,PG,22,OKC,17,17,638,135,343,.394,14,48,.292,121,295,.410,.414,121,142,.852,36,55,91,108,24,6,78,56,405
Damien Wilkins,2011,SF,31,ATL,8,0,39,7,13,.538,0,2,.000,7,11,.636,.538,0,0,,3,5,8,1,2,2,2,2,14
Lou Williams,2011,SG,24,PHI,5,0,130,17,52,.327,6,20,.300,11,32,.344,.385,14,19,.737,0,8,8,15,5,0,4,6,54
Marvin Williams,2011,SF,24,ATL,12,3,216,22,56,.393,3,11,.273,19,45,.422,.420,10,13,.769,10,17,27,6,9,7,12,18,57
Shawne Williams,2011,PF,24,NYK,4,0,101,10,24,.417,6,14,.429,4,10,.400,.542,6,8,.750,4,10,14,5,4,4,4,8,32
Metta World Peace,2011,SF,31,LAL,9,9,287,35,79,.443,9,28,.321,26,51,.510,.500,16,21,.762,17,24,41,20,10,7,9,23,95
Sam Young,2011,SF,25,MEM,13,11,256,43,96,.448,3,12,.250,40,84,.476,.464,9,15,.600,7,23,30,2,6,3,8,18,98
Thaddeus Young,2011,PF,22,PHI,5,0,127,25,60,.417,0,1,.000,25,59,.424,.417,7,12,.583,17,12,29,4,4,1,7,13,57
Arron Afflalo,2012,SG,26,DEN,7,7,229,30,74,.405,4,20,.200,26,54,.481,.432,12,15,.800,5,20,25,19,5,2,9,14,76
Blake Ahearn,2012,PG,27,UTA,3,0,8,2,3,.667,1,1,1.000,1,2,.500,.833,0,0,,0,0,0,2,0,0,0,0,5
Cole Aldrich,2012,C,23,OKC,5,0,25,4,9,.444,0,0,,4,9,.444,.444,2,4,.500,5,8,13,0,0,0,0,3,10
Lavoy Allen,2012,PF,22,PHI,12,1,236,34,61,.557,0,0,,34,61,.557,.557,7,12,.583,21,38,59,3,10,11,5,30,75
Ray Allen*,2012,SG,36,BOS,18,10,616,66,167,.395,28,92,.304,38,75,.507,.479,32,45,.711,8,66,74,18,17,2,17,41,192
Tony Allen,2012,SG,30,MEM,7,7,170,18,45,.400,0,5,.000,18,40,.450,.400,12,17,.706,8,14,22,5,9,7,10,21,48
Lou Amundson,2012,PF,29,IND,11,0,94,12,23,.522,0,0,,12,23,.522,.522,3,6,.500,6,17,23,2,2,5,4,16,27
James Anderson,2012,SG,22,SAS,8,0,31,4,9,.444,2,4,.500,2,5,.400,.556,1,2,.500,0,5,5,3,1,0,0,1,11
Ryan Anderson,2012,PF,23,ORL,5,5,172,15,44,.341,12,30,.400,3,14,.214,.477,6,7,.857,9,14,23,4,3,2,9,22,48
Carmelo Anthony,2012,SF,27,NYK,5,5,204,52,124,.419,4,18,.222,48,106,.453,.435,31,41,.756,13,28,41,11,6,1,14,21,139
Joel Anthony,2012,C,29,MIA,17,1,329,17,29,.586,0,0,,17,29,.586,.586,20,25,.800,22,33,55,2,5,16,8,41,54
Gilbert Arenas,2012,PG,30,MEM,6,0,23,2,8,.250,0,4,.000,2,4,.500,.250,0,0,,0,1,1,1,0,0,1,6,4
Ãmer AÅÄ±k,2012,C,25,CHI,6,3,128,7,14,.500,0,0,,7,14,.500,.500,6,17,.353,8,20,28,8,1,10,8,14,20
Jeff Ayres,2012,C,24,IND,4,0,9,1,3,.333,0,0,,1,3,.333,.333,0,0,,0,2,2,0,0,0,0,2,2
Kelenna Azubuike,2012,SG,28,DAL,1,0,5,1,3,.333,1,1,1.000,0,2,.000,.500,0,0,,1,0,1,0,1,0,1,0,3
Leandro Barbosa,2012,SG,29,IND,11,0,223,27,73,.370,3,20,.150,24,53,.453,.390,6,12,.500,5,19,24,14,5,1,13,23,63
Matt Barnes,2012,SF,31,LAL,11,0,185,16,59,.271,5,31,.161,11,28,.393,.314,2,4,.500,9,27,36,16,10,5,15,29,39
Brandon Bass,2012,PF,26,BOS,20,20,608,81,175,.463,0,0,,81,175,.463,.463,59,64,.922,26,79,105,15,14,10,15,50,221
Shane Battier,2012,SF,33,MIA,23,16,768,53,140,.379,42,110,.382,11,30,.367,.529,13,16,.813,15,59,74,27,22,14,16,69,161
Rodrigue Beaubois,2012,PG,23,DAL,2,0,12,0,2,.000,0,1,.000,0,1,.000,.000,0,0,,0,1,1,2,0,0,1,1,0
Mike Bibby,2012,PG,33,NYK,5,1,118,9,23,.391,7,17,.412,2,6,.333,.543,2,3,.667,3,18,21,13,1,0,4,7,27
DeJuan Blair,2012,PF,22,SAS,10,0,76,17,27,.630,0,0,,17,27,.630,.630,3,6,.500,7,16,23,2,3,1,1,10,37
Steve Blake,2012,PG,31,LAL,12,0,306,26,62,.419,18,43,.419,8,19,.421,.565,5,7,.714,8,26,34,27,8,2,15,21,75
Eric Bledsoe,2012,PG,22,LAC,11,0,189,37,63,.587,3,7,.429,34,56,.607,.611,10,16,.625,12,14,26,23,13,4,15,23,87
Matt Bonner,2012,PF,31,SAS,13,0,165,10,32,.313,8,23,.348,2,9,.222,.438,3,5,.600,2,23,25,9,2,4,3,24,31
Carlos Boozer,2012,PF,30,CHI,6,6,200,38,90,.422,0,0,,38,90,.422,.422,5,7,.714,10,49,59,18,5,2,23,20,81
Chris Bosh*,2012,PF,27,MIA,14,10,439,73,148,.493,7,13,.538,66,135,.489,.517,43,52,.827,36,73,109,8,6,14,20,20,196
Avery Bradley,2012,PG,21,BOS,10,10,248,25,68,.368,5,22,.227,20,46,.435,.404,12,18,.667,3,17,20,8,8,6,10,20,67
Elton Brand,2012,C,32,PHI,13,13,356,46,99,.465,0,0,,46,99,.465,.465,20,32,.625,22,41,63,7,11,20,7,36,112
Corey Brewer,2012,SF,25,DEN,7,0,116,23,54,.426,6,20,.300,17,34,.500,.481,6,8,.750,6,8,14,6,7,2,2,11,58
Ronnie Brewer,2012,SG,26,CHI,5,0,83,4,16,.250,0,0,,4,16,.250,.250,0,3,.000,4,15,19,9,4,1,6,5,8
Kobe Bryant*,2012,SG,33,LAL,12,12,476,132,301,.439,17,60,.283,115,241,.477,.467,79,95,.832,16,42,58,52,16,2,34,33,360
Alec Burks,2012,SG,20,UTA,4,0,63,7,28,.250,0,2,.000,7,26,.269,.250,12,14,.857,5,6,11,3,2,0,3,4,26
Caron Butler,2012,SF,31,LAC,10,10,268,33,92,.359,8,31,.258,25,61,.410,.402,12,16,.750,4,26,30,10,6,2,16,22,86
Jimmy Butler,2012,SG,22,CHI,3,0,4,0,0,,0,0,,0,0,,,0,0,,0,0,0,0,0,0,0,1,0
Andrew Bynum,2012,C,24,LAL,12,12,451,73,153,.477,0,0,,73,153,.477,.477,54,69,.783,46,87,133,18,5,37,16,21,200
Brian Cardinal,2012,SF,34,DAL,2,0,9,1,2,.500,1,1,1.000,0,1,.000,.750,0,0,,0,3,3,0,0,0,0,0,3
DeMarre Carroll,2012,SF,25,UTA,4,0,73,9,19,.474,1,5,.200,8,14,.571,.500,0,0,,7,8,15,3,2,1,3,9,19
Vince Carter,2012,SG,35,DAL,4,0,107,12,41,.293,3,10,.300,9,31,.290,.329,6,8,.750,5,17,22,1,5,2,6,11,33
Mario Chalmers,2012,PG,25,MIA,23,23,819,92,208,.442,33,92,.359,59,116,.509,.522,43,60,.717,12,72,84,90,28,6,42,69,260
Tyson Chandler,2012,C,29,NYK,5,5,167,11,25,.440,0,0,,11,25,.440,.440,9,15,.600,18,27,45,4,7,7,15,18,31
Earl Clark,2012,PF,24,ORL,5,0,88,8,18,.444,0,0,,8,18,.444,.444,4,7,.571,8,25,33,1,2,5,4,6,20
Norris Cole,2012,PG,23,MIA,19,0,170,12,37,.324,3,12,.250,9,25,.360,.365,7,9,.778,1,9,10,12,7,0,5,24,34
Jason Collins,2012,C,33,ATL,5,4,85,6,11,.545,0,0,,6,11,.545,.545,0,0,,4,8,12,0,1,0,10,16,12
Darren Collison,2012,PG,24,IND,11,0,205,36,70,.514,4,11,.364,32,59,.542,.543,20,23,.870,3,11,14,33,14,0,11,11,96
Nick Collison,2012,PF,31,OKC,20,0,332,33,51,.647,0,0,,33,51,.647,.647,3,7,.429,30,37,67,19,12,5,12,51,69
Mike Conley,2012,PG,24,MEM,7,7,277,32,76,.421,11,22,.500,21,54,.389,.493,24,32,.750,4,19,23,50,6,0,16,19,99
Daequan Cook,2012,SG,24,OKC,16,0,109,14,37,.378,8,24,.333,6,13,.462,.486,0,2,.000,0,9,9,4,3,0,0,7,36
Dante Cunningham,2012,PF,24,MEM,7,0,49,4,11,.364,0,0,,4,11,.364,.364,0,0,,6,5,11,0,1,2,1,3,8
Erick Dampier,2012,C,36,ATL,4,0,55,7,13,.538,0,0,,7,13,.538,.538,2,3,.667,7,7,14,0,0,1,3,6,16
Marquis Daniels,2012,SG,31,BOS,15,0,92,11,19,.579,0,2,.000,11,17,.647,.579,8,10,.800,1,9,10,3,2,1,2,13,30
Baron Davis,2012,PG,32,NYK,4,4,97,11,23,.478,4,14,.286,7,9,.778,.565,5,5,1.000,0,3,3,13,0,0,13,15,31
Glen Davis,2012,PF,26,ORL,5,5,190,39,89,.438,0,0,,39,89,.438,.438,17,22,.773,23,23,46,4,3,6,9,10,95
Luol Deng,2012,SF,26,CHI,6,6,228,36,79,.456,8,22,.364,28,57,.491,.506,4,7,.571,8,42,50,9,5,9,10,10,84
Boris Diaw,2012,PF,29,SAS,14,14,346,36,70,.514,9,18,.500,27,52,.519,.579,6,8,.750,28,45,73,35,11,4,15,29,87
Keyon Dooling,2012,SG,31,BOS,20,0,212,21,48,.438,11,28,.393,10,20,.500,.552,2,3,.667,2,13,15,14,6,4,3,30,55
Toney Douglas,2012,PG,25,NYK,1,0,8,1,1,1.000,0,0,,1,1,1.000,1.000,0,0,,0,0,0,1,0,0,0,0,2
Chris Duhon,2012,PG,29,ORL,5,0,61,1,5,.200,1,3,.333,0,2,.000,.300,0,2,.000,0,7,7,9,5,1,7,5,3
Tim Duncan*,2012,C,35,SAS,14,14,463,101,204,.495,0,1,.000,101,203,.498,.495,41,58,.707,32,99,131,39,10,29,21,30,243
Kevin Durant,2012,SF,23,OKC,20,20,837,198,383,.517,41,110,.373,157,273,.575,.570,133,154,.864,13,135,148,74,29,24,63,51,570
Devin Ebanks,2012,SG,22,LAL,9,6,126,16,39,.410,0,3,.000,16,36,.444,.410,5,8,.625,7,13,20,6,3,7,2,13,37
Jeremy Evans,2012,SF,24,UTA,2,0,7,0,1,.000,0,0,,0,1,.000,.000,2,2,1.000,0,3,3,1,1,0,0,1,2
Reggie Evans,2012,PF,31,LAC,11,0,198,8,15,.533,0,0,,8,15,.533,.533,17,40,.425,20,60,80,1,9,6,9,31,33
Christian Eyenga,2012,SF,22,LAL,3,0,9,2,3,.667,0,0,,2,3,.667,.667,0,1,.000,1,1,2,1,1,1,1,3,4
Kenneth Faried,2012,PF,22,DEN,7,7,192,32,60,.533,0,0,,32,60,.533,.533,9,12,.750,25,45,70,4,5,8,14,20,73
Derrick Favors,2012,PF,20,UTA,4,1,116,15,36,.417,0,0,,15,36,.417,.417,17,29,.586,14,24,38,2,5,6,5,11,47
Landry Fields,2012,SG,23,NYK,5,4,115,15,31,.484,1,5,.200,14,26,.538,.500,5,7,.714,4,11,15,7,3,0,9,5,36
Derek Fisher,2012,PG,37,OKC,20,0,446,49,118,.415,18,48,.375,31,70,.443,.492,9,9,1.000,2,30,32,25,17,2,6,37,125
Randy Foye,2012,SG,28,LAC,11,11,291,29,74,.392,14,32,.438,15,42,.357,.486,11,13,.846,4,18,22,17,6,3,12,19,83
Enes Freedom,2012,C,19,UTA,4,0,43,7,16,.438,0,0,,7,16,.438,.438,0,1,.000,8,8,16,1,0,4,4,7,14
Danilo Gallinari,2012,SF,23,DEN,7,7,222,34,94,.362,4,23,.174,30,71,.423,.383,22,24,.917,9,27,36,17,5,4,9,15,94
Kevin Garnett*,2012,C,35,BOS,20,20,737,159,320,.497,1,4,.250,158,316,.500,.498,65,80,.813,31,175,206,30,23,29,44,59,384
Marc Gasol,2012,C,27,MEM,7,7,261,36,69,.522,0,1,.000,36,68,.529,.522,34,43,.791,16,31,47,22,2,13,13,25,106
Pau Gasol,2012,PF,31,LAL,12,12,444,62,143,.434,2,5,.400,60,138,.435,.441,24,29,.828,38,76,114,44,6,25,20,36,150
Rudy Gay,2012,SF,25,MEM,7,7,279,48,114,.421,4,19,.211,44,95,.463,.439,33,40,.825,10,36,46,10,9,2,21,15,133
Paul George,2012,SG,21,IND,11,11,371,37,95,.389,11,41,.268,26,54,.481,.447,22,28,.786,15,58,73,26,18,4,21,32,107
Taj Gibson,2012,PF,26,CHI,6,0,137,21,46,.457,0,0,,21,46,.457,.457,15,22,.682,15,24,39,4,4,10,3,19,57
Manu GinÃ³bili*,2012,SG,34,SAS,14,2,390,65,145,.448,23,68,.338,42,77,.545,.528,48,56,.857,8,41,49,56,10,4,42,36,201
Andrew Goudelock,2012,SG,23,LAL,4,0,10,2,3,.667,1,1,1.000,1,2,.500,.833,0,0,,0,1,1,0,0,0,0,1,5
Danny Granger,2012,SF,28,IND,11,11,420,69,174,.397,26,73,.356,43,101,.426,.471,23,28,.821,15,47,62,27,6,4,29,31,187
Danny Green,2012,SG,24,SAS,14,12,289,38,91,.418,20,58,.345,18,33,.545,.527,7,10,.700,3,42,45,15,7,10,15,24,103
Willie Green,2012,SG,30,ATL,5,0,63,6,13,.462,1,4,.250,5,9,.556,.500,0,0,,1,7,8,3,0,0,2,6,13
Blake Griffin,2012,PF,22,LAC,11,11,393,84,168,.500,0,1,.000,84,167,.503,.500,42,66,.636,19,57,76,27,20,10,25,41,210
Hamed Haddadi,2012,C,26,MEM,4,0,21,2,2,1.000,0,0,,2,2,1.000,1.000,1,2,.500,5,4,9,1,0,2,1,5,5
Jordan Hamilton,2012,SF,21,DEN,2,0,5,2,3,.667,0,0,,2,3,.667,.667,0,0,,0,0,0,0,1,0,1,1,4
Richard Hamilton,2012,SG,33,CHI,6,6,171,29,70,.414,2,6,.333,27,64,.422,.429,18,22,.818,8,11,19,18,1,0,8,15,78
Tyler Hansbrough,2012,PF,26,IND,11,0,164,17,50,.340,0,0,,17,50,.340,.340,14,21,.667,12,23,35,6,5,3,8,22,48
James Harden,2012,SG,22,OKC,20,0,630,93,214,.435,32,78,.410,61,136,.449,.509,108,126,.857,13,89,102,68,31,2,42,67,326
Justin Harper,2012,PF,22,ORL,1,0,5,0,1,.000,0,0,,0,1,.000,.000,0,0,,0,0,0,0,0,0,0,0,0
Josh Harrellson,2012,PF,22,NYK,4,0,25,4,9,.444,0,1,.000,4,8,.500,.444,2,2,1.000,3,5,8,0,0,0,2,6,10
Al Harrington,2012,PF,31,DEN,7,0,163,24,75,.320,10,35,.286,14,40,.350,.387,10,15,.667,7,23,30,6,3,1,3,13,68
Devin Harris,2012,PG,28,UTA,4,4,120,19,48,.396,4,15,.267,15,33,.455,.438,10,14,.714,0,6,6,15,3,2,12,14,52
Terrel Harris,2012,SG,24,MIA,4,0,10,1,2,.500,0,1,.000,1,1,1.000,.500,3,4,.750,0,3,3,0,0,0,0,0,5
Udonis Haslem,2012,PF,31,MIA,22,11,452,40,88,.455,0,0,,40,88,.455,.455,26,35,.743,37,104,141,13,5,6,20,60,106
Spencer Hawes,2012,C,23,PHI,13,12,332,50,108,.463,2,5,.400,48,103,.466,.472,19,26,.731,18,68,86,21,4,11,22,32,121
Gordon Hayward,2012,SF,21,UTA,4,4,123,6,33,.182,1,12,.083,5,21,.238,.197,16,16,1.000,2,9,11,12,3,0,3,4,29
Lazar Hayward,2012,SF,25,OKC,5,0,18,2,3,.667,0,0,,2,3,.667,.667,0,0,,0,4,4,0,0,0,1,2,4
Brendan Haywood,2012,C,32,DAL,4,4,61,4,14,.286,0,0,,4,14,.286,.286,5,8,.625,7,6,13,1,1,2,2,8,13
Roy Hibbert,2012,C,25,IND,11,11,340,52,104,.500,1,1,1.000,51,103,.495,.505,24,36,.667,45,78,123,12,4,34,22,38,129
George Hill,2012,PG,25,IND,11,11,346,47,105,.448,15,40,.375,32,65,.492,.519,39,46,.848,9,16,25,32,13,3,22,21,148
Jordan Hill,2012,C,24,LAL,12,0,217,23,53,.434,0,0,,23,53,.434,.434,11,16,.688,39,37,76,1,3,8,7,32,57
Kirk Hinrich,2012,SG,31,ATL,6,4,141,13,30,.433,6,16,.375,7,14,.500,.533,2,2,1.000,4,8,12,6,4,0,2,9,34
Jrue Holiday,2012,PG,21,PHI,13,13,494,74,179,.413,20,49,.408,54,130,.415,.469,38,44,.864,17,44,61,67,20,8,26,24,206
Ryan Hollins,2012,C,27,BOS,17,0,170,11,26,.423,0,0,,11,26,.423,.423,4,9,.444,16,11,27,8,0,8,7,29,26
Al Horford,2012,C,25,ATL,3,2,108,20,34,.588,0,0,,20,34,.588,.588,6,8,.750,5,20,25,8,4,4,12,11,46
Josh Howard,2012,SF,31,UTA,4,3,63,5,17,.294,1,2,.500,4,15,.267,.324,4,5,.800,4,10,14,4,2,1,2,3,15
Juwan Howard,2012,PF,38,MIA,9,0,24,2,7,.286,0,0,,2,7,.286,.286,3,4,.750,0,1,1,0,0,0,0,0,7
Serge Ibaka,2012,PF,22,OKC,20,20,569,84,159,.528,1,4,.250,83,155,.535,.531,26,36,.722,47,68,115,12,11,59,11,57,195
Andre Iguodala,2012,SF,28,PHI,13,13,505,58,151,.384,19,49,.388,39,102,.382,.447,33,56,.589,17,57,74,48,19,5,19,32,168
Royal Ivey,2012,SG,30,OKC,5,0,21,4,11,.364,2,5,.400,2,6,.333,.455,1,2,.500,1,2,3,1,2,0,1,2,11
Stephen Jackson,2012,SF,33,SAS,14,0,299,38,71,.535,26,43,.605,12,28,.429,.718,14,15,.933,5,23,28,24,9,3,18,38,116
LeBron James,2012,SF,27,MIA,23,23,983,251,502,.500,22,85,.259,229,417,.549,.522,173,234,.739,54,170,224,129,43,16,81,47,697
Al Jefferson,2012,C,27,UTA,4,4,141,36,68,.529,0,1,.000,36,67,.537,.529,1,4,.250,7,27,34,10,5,3,5,10,73
Jared Jeffries,2012,PF,30,NYK,5,0,34,1,6,.167,0,0,,1,6,.167,.167,0,0,,6,6,12,0,1,0,1,5,2
Yi Jianlian,2012,PF,24,DAL,1,0,5,1,3,.333,0,1,.000,1,2,.500,.333,0,1,.000,0,2,2,0,1,0,0,0,2
Ivan Johnson,2012,PF,27,ATL,5,0,54,5,16,.313,0,1,.000,5,15,.333,.313,3,5,.600,7,10,17,0,3,0,3,7,13
Joe Johnson,2012,SG,30,ATL,6,6,243,38,102,.373,9,36,.250,29,66,.439,.417,18,24,.750,6,15,21,21,8,1,16,11,103
Dahntay Jones,2012,SF,31,IND,7,0,58,4,18,.222,2,9,.222,2,9,.222,.278,7,7,1.000,4,3,7,3,1,0,3,11,17
James Jones,2012,SG,31,MIA,20,0,173,16,43,.372,9,30,.300,7,13,.538,.477,10,10,1.000,5,15,20,2,3,1,4,12,51
DeAndre Jordan,2012,C,23,LAC,11,11,249,21,40,.525,0,0,,21,40,.525,.525,8,24,.333,18,40,58,4,7,18,7,20,50
Jerome Jordan,2012,C,25,NYK,1,0,4,1,2,.500,0,0,,1,2,.500,.500,0,0,,2,0,2,0,0,0,0,0,2
Jason Kidd*,2012,PG,38,DAL,4,4,144,14,41,.341,9,26,.346,5,15,.333,.451,9,10,.900,3,21,24,24,12,1,11,7,46
Kyle Korver,2012,SG,30,CHI,6,0,94,9,22,.409,4,13,.308,5,9,.556,.500,1,2,.500,1,9,10,9,3,3,5,10,23
Kosta Koufos,2012,C,22,DEN,3,2,26,1,3,.333,0,0,,1,3,.333,.333,0,0,,4,7,11,0,0,1,3,5,2
Ty Lawson,2012,PG,24,DEN,7,7,242,56,109,.514,9,28,.321,47,81,.580,.555,12,19,.632,4,14,18,42,7,1,8,12,133
Kawhi Leonard,2012,SF,20,SAS,14,14,379,45,90,.500,18,40,.450,27,50,.540,.600,13,16,.813,18,65,83,8,17,6,13,23,121
John Lucas III,2012,PG,29,CHI,5,0,94,18,40,.450,5,13,.385,13,27,.481,.513,2,2,1.000,2,5,7,9,0,0,6,7,43
Ian Mahinmi,2012,C,25,DAL,4,0,70,9,14,.643,0,0,,9,14,.643,.643,11,13,.846,9,9,18,0,3,3,1,13,29
Shawn Marion,2012,SF,33,DAL,4,4,140,17,40,.425,4,14,.286,13,26,.500,.475,9,10,.900,9,23,32,4,1,5,10,14,47
Kenyon Martin,2012,PF,34,LAC,11,0,193,22,42,.524,0,0,,22,42,.524,.524,5,8,.625,11,24,35,3,4,19,4,36,49
O.J. Mayo,2012,SG,24,MEM,7,0,163,17,62,.274,7,24,.292,10,38,.263,.331,21,27,.778,2,23,25,15,9,1,18,18,62
JaVale McGee,2012,C,24,DEN,7,0,181,23,53,.434,0,0,,23,53,.434,.434,14,26,.538,23,44,67,5,5,22,4,21,60
Tracy McGrady*,2012,SF,32,ATL,6,0,90,10,26,.385,0,4,.000,10,22,.455,.385,5,6,.833,6,11,17,6,0,2,10,4,25
Josh McRoberts,2012,PF,24,LAL,6,0,16,1,4,.250,0,1,.000,1,3,.333,.250,0,0,,0,4,4,1,0,1,2,1,2
Jodie Meeks,2012,SG,24,PHI,13,1,102,9,26,.346,3,13,.231,6,13,.462,.404,14,14,1.000,2,2,4,4,3,1,4,11,35
Andre Miller,2012,SG,35,DEN,7,0,200,31,73,.425,4,7,.571,27,66,.409,.452,13,15,.867,14,25,39,42,9,1,17,19,79
Mike Miller,2012,SG,31,MIA,23,0,368,40,99,.404,31,75,.413,9,24,.375,.561,9,11,.818,9,49,58,17,9,2,12,41,120
Patty Mills,2012,PG,23,SAS,8,0,31,6,11,.545,3,5,.600,3,6,.500,.682,0,0,,1,2,3,5,1,0,3,2,15
Paul Millsap,2012,PF,26,UTA,4,4,139,20,54,.370,0,3,.000,20,51,.392,.370,8,16,.500,17,27,44,2,1,10,9,11,48
Nazr Mohammed,2012,C,34,OKC,8,0,83,8,16,.500,0,0,,8,16,.500,.500,2,4,.500,7,9,16,1,0,3,2,19,18
E'Twaun Moore,2012,PG,22,BOS,9,0,21,2,8,.250,0,2,.000,2,6,.333,.250,1,2,.500,0,3,3,3,0,1,1,2,5
Darius Morris,2012,PG,21,LAL,4,0,8,3,3,1.000,1,1,1.000,2,2,1.000,1.167,3,4,.750,0,0,0,3,0,0,1,1,10
Timofey Mozgov,2012,C,25,DEN,7,5,99,12,25,.480,0,0,,12,25,.480,.480,4,8,.500,10,13,23,3,2,6,5,16,28
Troy Murphy,2012,PF,31,LAL,4,0,15,1,1,1.000,1,1,1.000,0,0,,1.500,0,0,,0,3,3,0,0,0,2,0,3
Gary Neal,2012,SG,27,SAS,14,0,217,39,82,.476,16,36,.444,23,46,.500,.573,11,13,.846,1,17,18,19,2,0,11,21,105
Jameer Nelson,2012,PG,29,ORL,5,5,182,29,74,.392,8,25,.320,21,49,.429,.446,12,16,.750,1,18,19,33,4,1,10,13,78
Joakim Noah,2012,C,26,CHI,3,3,99,19,26,.731,0,0,,19,26,.731,.731,7,11,.636,9,19,28,9,2,4,1,5,45
Steve Novak,2012,PF,28,NYK,5,1,95,4,9,.444,4,7,.571,0,2,.000,.667,0,0,,3,12,15,0,0,1,3,7,12
Dirk Nowitzki,2012,PF,33,DAL,4,4,154,34,77,.442,1,6,.167,33,71,.465,.448,38,42,.905,3,22,25,7,3,0,10,9,107
Daniel Orton,2012,PF,21,ORL,4,0,9,0,0,,0,0,,0,0,,,4,4,1.000,0,2,2,0,0,0,0,3,4
Jannero Pargo,2012,PG,32,ATL,5,0,46,6,21,.286,4,12,.333,2,9,.222,.381,0,0,,1,4,5,6,2,0,3,5,16
Tony Parker,2012,PG,29,SAS,14,14,506,102,225,.453,7,21,.333,95,204,.466,.469,71,88,.807,8,42,50,95,13,0,44,23,282
Chris Paul,2012,PG,26,LAC,11,11,423,70,164,.427,13,39,.333,57,125,.456,.466,41,47,.872,6,50,56,87,30,1,43,30,194
Sasha PavloviÄ,2012,SF,28,BOS,10,0,40,3,9,.333,1,5,.200,2,4,.500,.389,0,0,,2,3,5,1,1,1,4,4,7
Kendrick Perkins,2012,C,27,OKC,20,20,517,37,89,.416,0,0,,37,89,.416,.416,20,25,.800,35,89,124,13,7,25,29,59,94
Paul Pierce*,2012,SF,34,BOS,20,20,778,120,311,.386,27,87,.310,93,224,.415,.429,110,123,.894,14,107,121,62,30,18,56,68,377
MickaÃ«l PiÃ©trus,2012,SG,29,BOS,20,1,393,24,73,.329,12,54,.222,12,19,.632,.411,9,16,.563,12,29,41,2,14,5,9,50,69
Dexter Pittman,2012,C,23,MIA,3,1,8,0,2,.000,0,0,,0,2,.000,.000,0,0,,0,0,0,1,0,1,0,2,0
Quincy Pondexter,2012,SF,23,MEM,7,0,114,12,18,.667,2,4,.500,10,14,.714,.722,7,9,.778,3,13,16,2,4,0,5,13,33
A.J. Price,2012,PG,25,IND,4,0,7,1,2,.500,0,0,,1,2,.500,.500,0,0,,1,1,2,1,0,0,0,0,2
Vladimir RadmanoviÄ,2012,SF,31,ATL,2,0,15,0,4,.000,0,3,.000,0,1,.000,.000,0,0,,0,1,1,1,0,0,0,3,0
Zach Randolph,2012,PF,30,MEM,7,7,248,37,88,.420,0,4,.000,37,84,.440,.420,22,35,.629,27,42,69,6,7,4,11,25,96
J.J. Redick,2012,SG,27,ORL,5,0,123,19,44,.432,4,19,.211,15,25,.600,.477,12,14,.857,0,5,5,16,1,0,6,4,54
Jason Richardson,2012,SG,31,ORL,5,5,148,21,53,.396,10,27,.370,11,26,.423,.491,5,12,.417,4,15,19,5,6,2,6,7,57
Quentin Richardson,2012,SF,31,ORL,5,0,74,5,15,.333,2,7,.286,3,8,.375,.400,0,0,,0,22,22,2,1,0,6,6,12
Rajon Rondo,2012,PG,25,BOS,19,19,810,141,301,.468,8,30,.267,133,271,.491,.482,39,56,.696,35,93,128,227,45,2,72,40,329
Derrick Rose,2012,PG,23,CHI,1,1,37,9,23,.391,3,6,.500,6,17,.353,.457,2,2,1.000,3,6,9,9,1,1,5,1,23
Thabo Sefolosha,2012,SG,27,OKC,20,20,446,41,102,.402,16,49,.327,25,53,.472,.480,8,9,.889,11,42,53,26,30,9,11,44,106
Josh Selby,2012,PG,20,MEM,1,0,0,0,0,,0,0,,0,0,,,0,0,,0,0,0,0,0,0,0,0,0
Ramon Sessions,2012,PG,25,LAL,12,12,380,43,114,.377,4,25,.160,39,89,.438,.395,26,35,.743,3,33,36,43,4,1,22,27,116
Iman Shumpert,2012,PG,21,NYK,1,1,19,0,2,.000,0,1,.000,0,1,.000,.000,0,0,,0,1,1,0,1,0,1,2,0
Xavier Silas,2012,SG,24,PHI,2,0,4,1,1,1.000,0,0,,1,1,1.000,1.000,0,0,,1,1,2,0,0,0,0,0,2
Bobby Simmons,2012,SF,31,LAC,4,1,32,5,9,.556,1,4,.250,4,5,.800,.611,0,0,,0,1,1,0,0,0,1,7,11
Ish Smith,2012,PG,23,ORL,1,0,5,0,0,,0,0,,0,0,,,0,0,,0,1,1,0,0,1,0,0,0
J.R. Smith,2012,SG,26,NYK,5,0,175,24,76,.316,5,28,.179,19,48,.396,.349,8,8,1.000,2,11,13,11,6,1,11,19,61
Josh Smith,2012,PF,26,ATL,5,5,196,34,88,.386,0,4,.000,34,84,.405,.386,16,21,.762,10,58,68,24,3,5,15,14,84
Marreese Speights,2012,PF,24,MEM,7,0,100,20,41,.488,0,0,,20,41,.488,.488,6,10,.600,13,17,30,2,3,3,5,13,46
Tiago Splitter,2012,C,27,SAS,13,0,168,30,47,.638,0,0,,30,47,.638,.638,16,43,.372,8,28,36,10,5,4,9,24,76
Lance Stephenson,2012,SG,21,IND,4,0,12,2,9,.222,1,2,.500,1,7,.143,.278,1,2,.500,0,0,0,1,0,0,2,2,6
Greg Stiemsma,2012,C,26,BOS,19,0,143,12,18,.667,0,0,,12,18,.667,.667,4,6,.667,9,32,41,5,4,11,4,26,28
Julyan Stone,2012,SG,23,DEN,2,0,5,1,2,.500,0,0,,1,2,.500,.500,0,0,,1,0,1,2,0,0,0,0,2
Amar'e Stoudemire,2012,PF,29,NYK,4,4,139,20,36,.556,0,0,,20,36,.556,.556,21,28,.750,8,18,26,3,5,1,12,16,61
Jeff Teague,2012,PG,23,ATL,6,6,225,30,73,.411,7,17,.412,23,56,.411,.459,17,19,.895,4,18,22,25,5,5,10,18,84
Jason Terry,2012,SG,34,DAL,4,1,139,20,44,.455,10,20,.500,10,24,.417,.568,5,8,.625,1,8,9,15,1,0,8,11,55
Jamaal Tinsley,2012,PG,33,UTA,4,0,65,5,20,.250,1,4,.250,4,16,.250,.275,4,4,1.000,0,2,2,12,2,0,6,7,15
Ronny Turiaf,2012,C,29,MIA,12,7,121,10,18,.556,0,0,,10,18,.556,.556,3,11,.273,11,20,31,1,1,8,6,23,23
Hedo TÃ¼rkoÄlu,2012,SF,32,ORL,5,5,162,15,41,.366,5,12,.417,10,29,.345,.427,7,11,.636,4,10,14,12,5,4,9,18,42
Evan Turner,2012,SF,23,PHI,13,12,449,56,154,.364,0,6,.000,56,148,.378,.364,33,48,.688,14,84,98,32,12,6,30,36,145
Nikola VuÄeviÄ,2012,C,21,PHI,1,0,3,0,1,.000,0,0,,0,1,.000,.000,1,2,.500,0,1,1,0,0,0,0,0,1
Dwyane Wade,2012,SG,30,MIA,23,23,907,197,426,.462,10,34,.294,187,392,.477,.474,121,166,.729,32,88,120,100,39,30,68,65,525
Von Wafer,2012,SG,26,ORL,1,0,6,3,5,.600,0,0,,3,5,.600,.600,0,0,,0,1,1,0,0,0,1,1,6
C.J. Watson,2012,PG,27,CHI,6,5,164,14,58,.241,4,16,.250,10,42,.238,.276,12,16,.750,1,12,13,33,5,0,7,16,44
David West,2012,PF,31,IND,11,11,416,66,148,.446,0,0,,66,148,.446,.446,36,44,.818,21,73,94,22,8,6,17,33,168
Delonte West,2012,PG,28,DAL,4,3,88,11,26,.423,3,6,.500,8,20,.400,.481,5,5,1.000,2,5,7,8,3,0,3,5,30
Russell Westbrook,2012,PG,23,OKC,20,20,767,177,407,.435,18,65,.277,159,342,.465,.457,89,111,.802,22,87,109,117,31,8,45,49,461
Lou Williams,2012,PG,25,PHI,13,0,358,50,142,.352,8,48,.167,42,94,.447,.380,41,52,.788,3,24,27,39,13,0,16,17,149
Marvin Williams,2012,SF,25,ATL,6,3,145,16,45,.356,8,16,.500,8,29,.276,.444,7,9,.778,5,28,33,5,3,2,3,9,47
Mo Williams,2012,SG,29,LAC,11,0,229,41,94,.436,12,33,.364,29,61,.475,.500,12,13,.923,1,8,9,15,6,5,12,16,106
Sean Williams,2012,C,25,BOS,2,0,6,0,0,,0,0,,0,0,,,0,0,,0,1,1,0,0,0,1,1,0
Metta World Peace,2012,SF,32,LAL,6,6,236,22,60,.367,14,36,.389,8,24,.333,.483,12,16,.750,3,18,21,14,13,4,5,18,70
Brandan Wright,2012,C,24,DAL,4,0,27,2,5,.400,0,0,,2,5,.400,.400,1,2,.500,2,3,5,0,1,1,3,4,5
Nick Young,2012,SG,26,LAC,11,0,200,29,67,.433,17,33,.515,12,34,.353,.560,16,18,.889,1,11,12,3,3,4,7,20,91
Sam Young,2012,SF,26,PHI,2,0,4,0,2,.000,0,1,.000,0,1,.000,.000,0,0,,0,0,0,0,0,0,0,0,0
Thaddeus Young,2012,PF,23,PHI,13,0,277,39,91,.429,0,0,,39,91,.429,.429,22,31,.710,25,43,68,15,7,7,15,25,100
Ray Allen*,2013,SG,37,MIA,23,0,573,74,172,.430,39,96,.406,35,76,.461,.544,47,54,.870,13,51,64,29,12,3,27,42,234
Tony Allen,2013,SG,31,MEM,15,15,422,54,125,.432,2,8,.250,52,117,.444,.440,44,58,.759,37,54,91,27,30,5,19,48,154
Chris Andersen,2013,C,34,MIA,20,0,303,46,57,.807,0,0,,46,57,.807,.807,36,49,.735,32,44,76,3,9,22,11,53,128
James Anderson,2013,SG,23,HOU,2,0,18,1,5,.200,0,3,.000,1,2,.500,.200,0,0,,1,3,4,0,0,0,0,2,2
Carmelo Anthony,2013,PF,28,NYK,12,12,481,126,310,.406,17,57,.298,109,253,.431,.434,77,87,.885,11,68,79,19,13,2,31,46,346
Joel Anthony,2013,C,30,MIA,14,0,71,3,10,.300,0,0,,3,10,.300,.300,0,0,,10,11,21,0,2,4,3,13,6
Darrell Arthur,2013,PF,24,MEM,15,0,175,25,53,.472,0,2,.000,25,51,.490,.472,8,9,.889,14,24,38,6,2,4,7,36,58
Ãmer AÅÄ±k,2013,C,26,HOU,6,6,208,22,39,.564,0,0,,22,39,.564,.564,30,47,.638,21,46,67,3,3,10,12,22,74
D.J. Augustin,2013,PG,25,IND,19,1,316,27,71,.380,19,48,.396,8,23,.348,.514,25,31,.806,2,13,15,13,7,0,10,26,98
Gustavo AyÃ³n,2013,C,27,MIL,3,0,7,2,4,.500,0,0,,2,4,.500,.500,0,0,,0,0,0,0,0,0,0,0,4
Jeff Ayres,2013,PF,25,IND,9,0,71,8,24,.333,0,1,.000,8,23,.348,.333,0,0,,4,14,18,1,0,2,3,14,16
Harrison Barnes,2013,SF,20,GSW,12,12,461,72,162,.444,19,52,.365,53,110,.482,.503,30,35,.857,18,59,77,15,7,5,16,33,193
Matt Barnes,2013,SF,32,LAC,6,0,162,24,44,.545,7,17,.412,17,27,.630,.625,16,19,.842,7,23,30,3,4,2,5,23,71
Brandon Bass,2013,PF,27,BOS,6,5,204,14,29,.483,0,0,,14,29,.483,.483,12,15,.800,8,32,40,7,2,1,5,17,40
Shane Battier,2013,SF,34,MIA,22,0,392,27,93,.290,26,88,.295,1,5,.200,.430,23,28,.821,9,29,38,12,5,6,5,49,103
Jerryd Bayless,2013,PG,24,MEM,15,0,320,49,137,.358,18,59,.305,31,78,.397,.423,23,26,.885,1,29,30,32,7,5,16,35,139
Aron Baynes,2013,C,26,SAS,4,1,23,4,7,.571,0,0,,4,7,.571,.571,0,0,,2,3,5,0,0,0,1,4,8
Kent Bazemore,2013,SG,23,GSW,9,0,16,1,8,.125,0,1,.000,1,7,.143,.125,0,4,.000,1,4,5,2,1,0,2,3,2
Marco Belinelli,2013,SG,26,CHI,12,7,325,44,107,.411,16,47,.340,28,60,.467,.486,29,33,.879,0,35,35,31,5,0,15,26,133
Patrick Beverley,2013,PG,24,HOU,6,5,200,28,65,.431,8,24,.333,20,41,.488,.492,7,7,1.000,11,22,33,17,7,4,6,24,71
Andris BiedriÅÅ¡,2013,C,26,GSW,3,0,17,0,0,,0,0,,0,0,,,0,0,,2,5,7,1,0,2,1,6,0
Chauncey Billups,2013,SG,36,LAC,6,6,115,11,36,.306,6,17,.353,5,19,.263,.389,9,11,.818,2,10,12,6,1,1,8,10,37
DeJuan Blair,2013,PF,23,SAS,12,0,76,21,34,.618,0,0,,21,34,.618,.618,5,9,.556,6,18,24,7,5,1,1,14,47
Steve Blake,2013,PG,32,LAL,2,2,75,11,28,.393,5,12,.417,6,16,.375,.482,1,1,1.000,0,8,8,5,4,3,4,8,28
Andray Blatche,2013,C,26,BRK,7,0,138,29,58,.500,0,0,,29,58,.500,.500,14,17,.824,10,24,34,9,2,3,5,14,72
Eric Bledsoe,2013,PG,23,LAC,6,0,97,15,30,.500,1,9,.111,14,21,.667,.517,8,12,.667,2,13,15,18,2,3,5,10,39
Keith Bogans,2013,SG,32,BRK,2,0,23,0,1,.000,0,1,.000,0,0,,.000,0,0,,0,2,2,2,0,0,1,3,0
Andrew Bogut,2013,C,28,GSW,12,12,327,39,67,.582,0,0,,39,67,.582,.582,8,23,.348,39,92,131,22,6,18,22,39,86
Matt Bonner,2013,PF,32,SAS,20,1,267,28,59,.475,15,32,.469,13,27,.481,.602,10,12,.833,9,30,39,6,5,5,2,35,81
Carlos Boozer,2013,PF,31,CHI,12,12,431,83,168,.494,0,1,.000,83,167,.497,.494,31,45,.689,35,80,115,18,10,1,29,36,197
Chris Bosh*,2013,C,28,MIA,23,23,751,110,240,.458,15,37,.405,95,203,.468,.490,44,60,.733,38,129,167,34,23,36,27,67,279
Avery Bradley,2013,PG,22,BOS,6,6,191,17,42,.405,2,8,.250,15,34,.441,.429,4,4,1.000,3,10,13,8,11,1,11,11,40
Corey Brewer,2013,SF,26,DEN,6,0,146,21,68,.309,9,36,.250,12,32,.375,.375,14,21,.667,3,8,11,7,6,1,7,19,65
Ronnie Brewer,2013,SF,27,OKC,1,0,8,0,0,,0,0,,0,0,,,0,0,,0,1,1,0,0,0,0,1,0
Aaron Brooks,2013,PG,28,HOU,6,0,67,13,34,.382,1,9,.111,12,25,.480,.397,3,5,.600,3,6,9,11,1,1,6,3,30
MarShon Brooks,2013,SG,24,BRK,7,0,40,3,8,.375,0,1,.000,3,7,.429,.375,2,2,1.000,1,4,5,3,0,0,3,3,8
Caron Butler,2013,SF,32,LAC,6,6,136,22,46,.478,4,16,.250,18,30,.600,.522,3,3,1.000,1,15,16,0,2,2,6,11,51
Jimmy Butler,2013,SF,23,CHI,12,12,490,50,115,.435,15,37,.405,35,78,.449,.500,45,55,.818,9,53,62,32,15,6,16,26,160
Marcus Camby,2013,PF,38,NYK,3,0,3,1,1,1.000,0,0,,1,1,1.000,1.000,0,0,,1,1,2,0,0,0,1,1,2
Mario Chalmers,2013,PG,26,MIA,23,23,650,76,183,.415,24,68,.353,52,115,.452,.481,40,53,.755,10,43,53,71,21,1,38,70,216
Tyson Chandler,2013,C,30,NYK,12,12,350,28,52,.538,0,0,,28,52,.538,.538,12,16,.750,40,48,88,4,8,14,11,48,68
Wilson Chandler,2013,PF,25,DEN,6,6,205,27,76,.355,9,29,.310,18,47,.383,.414,9,12,.750,5,28,33,8,8,3,7,25,72
Earl Clark,2013,PF,25,LAL,4,1,82,7,19,.368,0,4,.000,7,15,.467,.368,0,0,,2,10,12,1,1,1,6,4,14
Norris Cole,2013,PG,24,MIA,21,0,418,49,102,.480,17,32,.531,32,70,.457,.564,14,19,.737,6,33,39,42,15,2,23,40,129
Nick Collison,2013,C,32,OKC,11,0,178,22,47,.468,0,0,,22,47,.468,.468,11,12,.917,25,26,51,12,5,11,10,37,55
Mike Conley,2013,PG,25,MEM,15,15,575,83,216,.384,18,64,.281,65,152,.428,.426,71,93,.763,12,59,71,107,26,5,34,34,255
Daequan Cook,2013,SG,25,CHI,6,0,36,1,10,.100,1,8,.125,0,2,.000,.150,0,0,,0,3,3,4,1,0,4,6,3
Chris Copeland,2013,PF,28,NYK,9,1,93,12,30,.400,11,23,.478,1,7,.143,.583,2,2,1.000,2,7,9,1,5,0,4,9,37
Jamal Crawford,2013,SG,32,LAC,6,0,161,24,62,.387,6,22,.273,18,40,.450,.435,11,11,1.000,2,10,12,10,3,1,4,9,65
Jordan Crawford,2013,SG,24,BOS,5,0,59,7,23,.304,3,12,.250,4,11,.364,.370,1,2,.500,0,3,3,0,2,0,3,3,18
Stephen Curry,2013,PG,24,GSW,12,12,497,102,235,.434,42,106,.396,60,129,.465,.523,35,38,.921,5,41,46,97,20,2,40,35,281
Samuel Dalembert,2013,C,31,MIL,1,0,9,0,2,.000,0,0,,0,2,.000,.000,1,4,.250,1,2,3,0,1,0,2,3,1
Marquis Daniels,2013,SF,32,MIL,3,0,33,6,11,.545,0,2,.000,6,9,.667,.545,0,0,,0,4,4,4,1,0,1,3,12
Ed Davis,2013,PF,23,MEM,8,0,48,5,12,.417,0,0,,5,12,.417,.417,3,4,.750,4,7,11,0,0,1,2,7,13
Austin Daye,2013,SF,24,MEM,4,0,20,3,8,.375,0,1,.000,3,7,.429,.375,1,1,1.000,0,1,1,0,0,1,1,2,7
Nando De Colo,2013,SG,25,SAS,5,0,14,1,4,.250,0,3,.000,1,1,1.000,.250,2,2,1.000,2,2,4,2,0,0,0,1,4
Carlos Delfino,2013,SF,30,HOU,5,0,120,15,40,.375,11,31,.355,4,9,.444,.513,4,4,1.000,1,11,12,10,3,1,5,10,45
Luol Deng,2013,SF,27,CHI,5,5,224,32,84,.381,1,18,.056,31,66,.470,.387,4,10,.400,5,33,38,19,5,3,12,12,69
Boris Diaw,2013,PF,30,SAS,16,1,273,24,54,.444,5,13,.385,19,41,.463,.491,12,14,.857,8,32,40,28,4,3,13,28,65
Keyon Dooling,2013,PG,32,MEM,14,0,114,8,24,.333,5,13,.385,3,11,.273,.438,6,6,1.000,0,5,5,4,1,0,3,14,27
Chris Duhon,2013,PG,30,LAL,2,0,68,4,11,.364,3,8,.375,1,3,.333,.500,0,0,,1,2,3,7,2,1,5,4,11
Tim Duncan*,2013,C,36,SAS,21,21,735,151,321,.470,0,1,.000,151,320,.472,.470,79,98,.806,54,160,214,40,18,34,42,53,381
Mike Dunleavy,2013,SF,32,MIL,4,0,91,17,30,.567,7,16,.438,10,14,.714,.683,8,9,.889,3,13,16,8,2,0,3,5,49
Kevin Durant,2013,SF,24,OKC,11,11,485,112,246,.455,22,70,.314,90,176,.511,.500,93,112,.830,7,92,99,69,14,12,43,26,339
Monta Ellis,2013,SG,27,MIL,4,4,152,24,55,.436,3,19,.158,21,36,.583,.464,6,16,.375,2,11,13,22,10,1,14,8,57
Reggie Evans,2013,PF,32,BRK,7,7,209,11,23,.478,0,0,,11,23,.478,.478,10,18,.556,16,70,86,6,7,2,6,21,32
Festus Ezeli,2013,C,23,GSW,12,3,134,6,13,.462,0,0,,6,13,.462,.462,12,21,.571,13,17,30,2,3,7,12,24,24
Kenneth Faried,2013,PF,23,DEN,5,4,145,20,32,.625,0,0,,20,32,.625,.625,11,15,.733,12,30,42,1,5,1,5,22,51
Raymond Felton,2013,PG,28,NYK,12,12,454,72,162,.444,9,28,.321,63,134,.470,.472,16,24,.667,17,24,41,56,20,5,20,26,169
Derek Fisher,2013,SG,38,OKC,11,0,261,32,70,.457,24,51,.471,8,19,.421,.629,8,12,.667,1,16,17,8,7,1,8,33,96
Evan Fournier,2013,SG,20,DEN,4,4,53,6,17,.353,0,8,.000,6,9,.667,.353,7,8,.875,0,0,0,4,2,0,6,6,19
Francisco GarcÃ­a,2013,SF,31,HOU,6,3,164,22,50,.440,17,37,.459,5,13,.385,.610,3,5,.600,3,17,20,9,4,5,4,21,64
Kevin Garnett*,2013,C,36,BOS,6,6,212,30,60,.500,0,2,.000,30,58,.517,.500,16,17,.941,9,73,82,21,5,6,19,23,76
Marc Gasol,2013,C,28,MEM,15,15,609,93,205,.454,0,0,,93,205,.454,.454,72,90,.800,25,102,127,48,13,33,18,53,258
Pau Gasol,2013,PF,32,LAL,4,4,146,25,52,.481,0,0,,25,52,.481,.481,6,11,.545,7,39,46,26,2,3,13,4,56
Paul George,2013,SF,22,IND,19,19,780,119,277,.430,34,104,.327,85,173,.491,.491,93,128,.727,16,125,141,96,25,9,75,72,365
Taj Gibson,2013,PF,27,CHI,12,0,206,31,66,.470,0,2,.000,31,64,.484,.470,16,22,.727,15,21,36,4,4,6,9,37,78
Manu GinÃ³bili*,2013,SG,35,SAS,21,3,560,77,193,.399,29,96,.302,48,97,.495,.474,59,80,.738,9,69,78,105,24,6,55,52,242
Andrew Goudelock,2013,SG,24,LAL,3,2,80,16,36,.444,2,10,.200,14,26,.538,.472,2,2,1.000,1,4,5,3,5,0,4,7,36
Danny Green,2013,SG,25,SAS,21,21,669,83,186,.446,55,114,.482,28,72,.389,.594,12,15,.800,18,69,87,32,22,23,19,51,233
Draymond Green,2013,SF,22,GSW,12,1,223,24,56,.429,9,23,.391,15,33,.455,.509,13,17,.765,14,37,51,19,6,10,12,35,70
Gerald Green,2013,SF,27,IND,9,0,105,21,50,.420,11,33,.333,10,17,.588,.530,2,2,1.000,2,10,12,3,0,1,6,10,55
Jeff Green,2013,PF,26,BOS,6,6,258,37,85,.435,10,22,.455,27,63,.429,.494,38,45,.844,6,26,32,14,2,4,19,22,122
Willie Green,2013,SG,31,LAC,3,0,20,2,3,.667,0,1,.000,2,2,1.000,.667,2,2,1.000,0,3,3,2,1,0,0,0,6
Blake Griffin,2013,PF,23,LAC,6,5,158,29,64,.453,0,0,,29,64,.453,.453,21,26,.808,8,25,33,15,0,5,13,24,79
Jordan Hamilton,2013,SF,22,DEN,1,0,2,0,1,.000,0,0,,0,1,.000,.000,0,0,,0,0,0,0,0,0,0,0,0
Richard Hamilton,2013,SG,34,CHI,4,0,68,10,27,.370,3,7,.429,7,20,.350,.426,3,4,.750,0,3,3,5,1,2,5,5,26
Ben Hansbrough,2013,PG,25,IND,6,0,22,0,5,.000,0,3,.000,0,2,.000,.000,0,0,,1,2,3,3,0,1,2,2,0
Tyler Hansbrough,2013,PF,27,IND,19,0,241,26,62,.419,0,0,,26,62,.419,.419,26,44,.591,36,25,61,5,6,0,15,41,78
James Harden,2013,SG,23,HOU,6,6,243,45,115,.391,15,44,.341,30,71,.423,.457,53,66,.803,5,35,40,27,12,6,27,18,158
Devin Harris,2013,SG,29,ATL,6,6,225,23,63,.365,5,25,.200,18,38,.474,.405,17,25,.680,2,15,17,22,10,1,12,18,68
Udonis Haslem,2013,PF,32,MIA,22,19,357,51,86,.593,0,0,,51,86,.593,.593,8,14,.571,26,54,80,6,15,5,14,54,110
John Henson,2013,PF,22,MIL,4,0,33,3,11,.273,0,1,.000,3,10,.300,.273,0,0,,0,8,8,1,2,0,2,5,6
Roy Hibbert,2013,C,26,IND,19,19,694,120,235,.511,0,0,,120,235,.511,.511,83,103,.806,90,98,188,26,3,37,43,74,323
George Hill,2013,PG,26,IND,18,18,685,83,207,.401,34,95,.358,49,112,.438,.483,63,76,.829,5,62,67,77,22,4,40,41,263
Grant Hill*,2013,SF,40,LAC,1,0,20,2,4,.500,0,0,,2,4,.500,.500,0,0,,2,2,4,2,0,0,1,5,4
Jordan Hill,2013,PF,25,LAL,3,0,31,5,10,.500,0,0,,5,10,.500,.500,0,0,,2,9,11,1,0,2,0,2,10
Kirk Hinrich,2013,PG,32,CHI,4,4,162,16,37,.432,4,11,.364,12,26,.462,.486,9,14,.643,1,10,11,23,8,1,8,14,45
Ryan Hollins,2013,C,28,LAC,5,0,37,5,9,.556,0,0,,5,9,.556,.556,1,2,.500,3,2,5,2,0,2,2,10,11
Al Horford,2013,C,26,ATL,6,6,218,41,83,.494,0,0,,41,83,.494,.494,18,27,.667,12,41,53,18,6,5,9,17,100
Dwight Howard,2013,C,27,LAL,4,4,126,26,42,.619,0,0,,26,42,.619,.619,16,36,.444,10,33,43,4,2,8,16,17,68
Kris Humphries,2013,PF,27,BRK,7,0,83,14,31,.452,0,0,,14,31,.452,.452,3,7,.429,10,13,23,1,1,3,2,15,31
Serge Ibaka,2013,PF,23,OKC,11,11,366,59,135,.437,4,9,.444,55,126,.437,.452,19,24,.792,39,53,92,8,0,33,7,38,141
Andre Iguodala,2013,SG,29,DEN,6,6,243,38,76,.500,14,29,.483,24,47,.511,.592,18,25,.720,9,39,48,32,12,2,17,9,108
Ersan Ä°lyasova,2013,PF,25,MIL,4,4,117,20,46,.435,4,10,.400,16,36,.444,.478,2,2,1.000,10,19,29,7,5,1,6,8,46
Jarrett Jack,2013,SG,29,GSW,12,4,426,78,154,.506,7,24,.292,71,130,.546,.529,43,48,.896,7,46,53,56,11,4,38,26,206
Reggie Jackson,2013,PG,22,OKC,11,9,368,57,119,.479,13,43,.302,44,76,.579,.534,26,29,.897,4,50,54,40,5,6,21,34,153
LeBron James,2013,PF,28,MIA,23,23,960,212,432,.491,36,96,.375,176,336,.524,.532,136,175,.777,37,156,193,152,41,18,70,43,596
Antawn Jamison,2013,PF,36,LAL,4,0,79,10,23,.435,5,12,.417,5,11,.455,.543,4,6,.667,1,6,7,1,1,2,3,9,29
Richard Jefferson,2013,SF,32,GSW,7,0,39,4,9,.444,2,3,.667,2,6,.333,.556,3,9,.333,2,5,7,1,1,1,0,5,13
John Jenkins,2013,SG,21,ATL,4,0,24,0,3,.000,0,1,.000,0,2,.000,.000,0,0,,0,2,2,3,0,0,2,2,0
Brandon Jennings,2013,PG,23,MIL,4,4,133,17,57,.298,6,28,.214,11,29,.379,.351,13,18,.722,1,8,9,16,9,1,11,6,53
Ivan Johnson,2013,PF,28,ATL,6,0,108,12,26,.462,0,0,,12,26,.462,.462,12,18,.667,9,11,20,3,4,3,6,23,36
Joe Johnson,2013,SG,31,BRK,7,7,271,43,103,.417,10,39,.256,33,64,.516,.466,8,9,.889,4,18,22,19,8,0,12,13,104
Orlando Johnson,2013,SG,23,IND,12,0,28,2,11,.182,1,3,.333,1,8,.125,.227,5,9,.556,0,3,3,1,0,0,1,0,10
Dahntay Jones,2013,SF,32,ATL,5,0,19,1,4,.250,0,0,,1,4,.250,.250,2,2,1.000,0,1,1,0,0,0,1,1,4
Dwayne Jones,2013,PF,29,GSW,2,0,2,0,0,,0,0,,0,0,,,0,0,,0,0,0,0,0,0,0,0,0
James Jones,2013,SF,32,MIA,9,0,33,3,7,.429,3,4,.750,0,3,.000,.643,0,0,,0,3,3,0,0,1,2,3,9
Perry Jones,2013,SF,21,OKC,1,0,5,0,1,.000,0,0,,0,1,.000,.000,0,0,,0,1,1,0,0,0,0,0,0
Terrence Jones,2013,PF,21,HOU,2,0,35,4,10,.400,0,2,.000,4,8,.500,.400,0,3,.000,5,10,15,1,0,1,1,2,8
DeAndre Jordan,2013,C,24,LAC,6,6,144,10,22,.455,0,0,,10,22,.455,.455,2,9,.222,15,23,38,1,1,10,9,18,22
Cory Joseph,2013,PG,21,SAS,20,0,192,26,56,.464,2,11,.182,24,45,.533,.482,5,11,.455,8,23,31,24,6,2,10,15,59
Jason Kidd*,2013,SG,39,NYK,12,0,247,3,25,.120,3,17,.176,0,8,.000,.180,2,2,1.000,7,35,42,24,12,4,13,12,11
Kyle Korver,2013,SF,31,ATL,6,2,177,19,49,.388,12,34,.353,7,15,.467,.510,11,12,.917,0,20,20,4,2,4,6,14,61
Kosta Koufos,2013,C,23,DEN,6,2,100,7,19,.368,1,1,1.000,6,18,.333,.395,5,6,.833,9,12,21,3,3,4,2,13,20
Carl Landry,2013,PF,29,GSW,12,3,246,52,100,.520,0,0,,52,100,.520,.520,38,52,.731,22,40,62,17,7,2,19,29,142
Ty Lawson,2013,PG,25,DEN,6,6,236,48,109,.440,4,21,.190,44,88,.500,.459,28,33,.848,5,15,20,48,10,0,13,13,128
Courtney Lee,2013,SG,27,BOS,4,0,39,1,5,.200,0,2,.000,1,3,.333,.200,4,4,1.000,0,2,2,1,2,0,0,3,6
David Lee,2013,PF,29,GSW,6,1,65,13,33,.394,0,0,,13,33,.394,.394,4,6,.667,6,22,28,5,3,1,5,5,30
Kawhi Leonard,2013,SF,21,SAS,21,21,775,115,211,.545,23,59,.390,92,152,.605,.600,31,49,.633,50,140,190,22,37,11,23,40,284
Jon Leuer,2013,PF,23,MEM,5,0,11,1,2,.500,0,0,,1,2,.500,.500,0,0,,2,1,3,0,1,1,0,1,2
Rashard Lewis,2013,PF,33,MIA,11,0,47,8,20,.400,0,4,.000,8,16,.500,.400,1,2,.500,1,6,7,4,2,2,6,5,17
DeAndre Liggins,2013,SG,24,OKC,8,0,68,3,9,.333,1,5,.200,2,4,.500,.389,1,4,.250,0,14,14,4,1,1,2,10,8
Jeremy Lin,2013,PG,24,HOU,4,3,84,6,24,.250,2,12,.167,4,12,.333,.292,2,2,1.000,0,8,8,8,2,1,8,9,16
Brook Lopez,2013,C,24,BRK,7,7,263,58,123,.472,1,1,1.000,57,122,.467,.476,39,44,.886,29,23,52,10,6,21,16,20,156
Scott Machado,2013,PG,22,GSW,5,0,8,1,2,.500,0,0,,1,2,.500,.500,1,2,.500,0,1,1,1,0,0,1,1,3
Shelvin Mack,2013,PG,22,ATL,4,0,22,4,9,.444,2,5,.400,2,4,.500,.556,0,0,,3,4,7,7,0,0,0,0,10
Ian Mahinmi,2013,C,26,IND,18,0,150,13,29,.448,0,0,,13,29,.448,.448,3,10,.300,20,22,42,1,0,13,12,28,29
Kenyon Martin,2013,C,35,NYK,12,1,253,29,50,.580,0,0,,29,50,.580,.580,11,20,.550,16,38,54,11,9,17,8,42,69
Kevin Martin,2013,SG,29,OKC,11,0,323,49,129,.380,17,46,.370,32,83,.386,.446,39,43,.907,2,32,34,14,7,3,11,18,154
Luc Mbah a Moute,2013,SF,26,MIL,4,4,136,10,23,.435,0,4,.000,10,19,.526,.435,13,18,.722,4,10,14,7,4,0,5,9,33
JaVale McGee,2013,C,25,DEN,6,2,112,18,31,.581,0,0,,18,31,.581,.581,7,18,.389,17,14,31,0,4,6,11,17,43
Tracy McGrady*,2013,SF,33,SAS,6,0,31,0,7,.000,0,3,.000,0,4,.000,.000,0,0,,1,7,8,7,2,3,2,1,0
Jodie Meeks,2013,SG,25,LAL,1,0,20,1,4,.250,0,2,.000,1,2,.500,.250,2,2,1.000,1,1,2,0,1,0,2,2,4
Andre Miller,2013,PG,36,DEN,6,0,154,29,69,.420,5,11,.455,24,58,.414,.457,21,27,.778,11,9,20,23,2,0,16,8,84
Mike Miller,2013,SF,32,MIA,17,5,232,21,45,.467,16,36,.444,5,9,.556,.644,0,0,,3,30,33,15,8,2,5,26,58
Patty Mills,2013,PG,24,SAS,9,0,31,5,10,.500,2,7,.286,3,3,1.000,.600,0,0,,1,2,3,2,0,0,1,2,12
Nazr Mohammed,2013,C,35,CHI,12,0,114,21,41,.512,0,0,,21,41,.512,.512,4,7,.571,14,18,32,4,2,7,3,15,46
Darius Morris,2013,PG,22,LAL,4,2,105,16,35,.457,3,9,.333,13,26,.500,.500,7,9,.778,1,4,5,12,2,0,6,6,42
Donatas MotiejÅ«nas,2013,PF,22,HOU,1,0,5,2,2,1.000,0,0,,2,2,1.000,1.000,1,1,1.000,1,0,1,0,0,0,0,0,5
Steve Nash*,2013,PG,38,LAL,2,2,61,10,23,.435,0,3,.000,10,20,.500,.435,5,5,1.000,2,3,5,9,0,0,3,2,25
Gary Neal,2013,SG,28,SAS,21,0,390,52,135,.385,23,66,.348,29,69,.420,.470,16,16,1.000,1,44,45,15,3,1,13,33,143
Joakim Noah,2013,C,27,CHI,12,12,409,52,119,.437,0,0,,52,119,.437,.437,25,39,.641,52,63,115,28,10,26,24,43,129
Steve Novak,2013,SF,29,NYK,9,0,50,7,13,.538,4,9,.444,3,4,.750,.692,0,0,,2,2,4,0,1,0,0,5,18
Lamar Odom,2013,PF,33,LAC,6,1,107,11,30,.367,5,14,.357,6,16,.375,.450,3,6,.500,4,19,23,11,5,5,10,16,30
Tony Parker,2013,PG,30,SAS,21,21,765,167,365,.458,11,31,.355,156,334,.467,.473,87,112,.777,14,54,68,146,24,3,53,26,432
Chandler Parsons,2013,SF,24,HOU,6,6,238,42,93,.452,16,40,.400,26,53,.491,.538,9,14,.643,7,32,39,22,1,2,18,19,109
Chris Paul,2013,PG,27,LAC,6,6,224,49,92,.533,6,19,.316,43,73,.589,.565,33,37,.892,3,21,24,38,11,0,9,17,137
Kendrick Perkins,2013,C,28,OKC,11,11,210,10,38,.263,0,1,.000,10,37,.270,.263,4,4,1.000,15,26,41,7,8,5,23,39,24
Johan Petro,2013,C,27,ATL,6,4,101,14,27,.519,0,0,,14,27,.519,.519,1,2,.500,4,18,22,4,1,4,3,18,29
Paul Pierce*,2013,SF,35,BOS,6,6,255,39,106,.368,11,41,.268,28,65,.431,.420,26,29,.897,4,30,34,32,5,3,32,21,115
Quincy Pondexter,2013,SF,24,MEM,15,0,357,46,94,.489,24,53,.453,22,41,.537,.617,17,28,.607,9,29,38,11,11,2,9,31,133
Pablo Prigioni,2013,PG,35,NYK,11,10,230,17,43,.395,13,30,.433,4,13,.308,.547,2,4,.500,2,15,17,35,14,1,6,21,49
Tayshaun Prince,2013,SF,32,MEM,15,15,454,43,121,.355,5,19,.263,38,102,.373,.376,14,23,.609,12,45,57,29,7,5,10,18,105
Vladimir RadmanoviÄ,2013,PF,32,CHI,1,0,10,3,3,1.000,3,3,1.000,0,0,,1.500,0,0,,0,0,0,1,2,0,1,1,9
Anthony Randolph,2013,PF,23,DEN,5,0,30,9,11,.818,0,0,,9,11,.818,.818,8,11,.727,0,6,6,0,2,0,2,4,26
Shavlik Randolph,2013,PF,29,BOS,1,0,3,0,0,,0,0,,0,0,,,0,0,,0,3,3,0,0,0,0,1,0
Zach Randolph,2013,PF,31,MEM,15,15,554,99,215,.460,0,1,.000,99,214,.463,.460,63,94,.670,59,91,150,24,10,7,31,52,261
J.J. Redick,2013,SG,28,MIL,4,0,69,11,25,.440,4,12,.333,7,13,.538,.520,3,3,1.000,0,3,3,5,1,0,6,9,29
Quentin Richardson,2013,SF,32,NYK,5,0,14,2,6,.333,2,5,.400,0,1,.000,.500,0,0,,1,2,3,0,0,0,0,2,6
Nate Robinson,2013,PG,28,CHI,12,8,404,71,163,.436,22,65,.338,49,98,.500,.503,31,41,.756,6,26,32,53,12,2,32,38,195
Robert Sacre,2013,C,23,LAL,2,0,4,0,1,.000,0,0,,0,1,.000,.000,0,0,,0,2,2,0,1,0,0,0,0
Larry Sanders,2013,C,24,MIL,4,4,113,19,33,.576,0,0,,19,33,.576,.576,5,11,.455,11,22,33,5,3,5,12,18,43
Mike Scott,2013,PF,24,ATL,4,0,20,5,10,.500,0,1,.000,5,9,.556,.500,3,4,.750,1,6,7,1,0,0,0,2,13
Thabo Sefolosha,2013,SG,28,OKC,11,11,300,21,61,.344,12,38,.316,9,23,.391,.443,9,11,.818,13,36,49,23,12,5,8,26,63
Iman Shumpert,2013,SG,22,NYK,12,12,337,41,100,.410,18,42,.429,23,58,.397,.500,12,14,.857,18,54,72,16,13,3,14,36,112
Greg Smith,2013,C,22,HOU,5,1,59,6,9,.667,0,0,,6,9,.667,.667,6,12,.500,7,6,13,0,2,2,4,9,18
Ish Smith,2013,PG,24,MIL,4,0,11,0,1,.000,0,0,,0,1,.000,.000,0,0,,0,1,1,3,0,0,1,1,0
J.R. Smith,2013,SG,27,NYK,11,0,351,54,163,.331,18,66,.273,36,97,.371,.387,31,43,.721,6,46,52,15,11,5,20,27,157
Josh Smith,2013,PF,27,ATL,6,6,199,39,90,.433,5,20,.250,34,70,.486,.461,19,36,.528,10,35,45,21,11,3,16,21,102
Tiago Splitter,2013,PF,28,SAS,19,15,388,45,84,.536,0,1,.000,45,83,.542,.536,26,33,.788,21,37,58,23,15,14,24,46,116
Jerry Stackhouse,2013,SF,38,BRK,4,0,28,1,10,.100,0,7,.000,1,3,.333,.100,3,4,.750,1,3,4,0,0,0,2,2,5
Lance Stephenson,2013,SG,22,IND,19,19,673,69,169,.408,18,64,.281,51,105,.486,.462,23,37,.622,14,130,144,63,23,2,36,47,179
DeShawn Stevenson,2013,SG,31,ATL,4,0,45,3,5,.600,3,5,.600,0,0,,.900,0,0,,3,7,10,1,0,0,2,5,9
Julyan Stone,2013,PG,24,DEN,2,0,13,0,0,,0,0,,0,0,,,2,2,1.000,0,0,0,1,0,0,0,3,2
Amar'e Stoudemire,2013,PF,30,NYK,4,0,33,5,13,.385,1,1,1.000,4,12,.333,.423,4,4,1.000,4,5,9,0,0,0,3,9,15
Tyshawn Taylor,2013,PG,22,BRK,2,0,2,0,1,.000,0,0,,0,1,.000,.000,0,0,,0,0,0,0,0,0,0,0,0
Jeff Teague,2013,PG,24,ATL,6,6,213,27,81,.333,3,10,.300,24,71,.338,.352,23,28,.821,3,14,17,30,9,2,14,17,80
Marquis Teague,2013,PG,19,CHI,8,0,72,5,17,.294,0,5,.000,5,12,.417,.294,0,0,,0,3,3,12,2,1,2,10,10
Mirza TeletoviÄ,2013,PF,27,BRK,1,0,1,0,0,,0,0,,0,0,,,0,0,,0,0,0,0,0,0,0,0,0
Jason Terry,2013,SG,35,BOS,6,1,189,24,54,.444,15,34,.441,9,20,.450,.583,9,11,.818,0,13,13,12,4,2,5,9,72
Hasheem Thabeet,2013,C,25,OKC,4,0,26,1,2,.500,0,0,,1,2,.500,.500,0,0,,1,5,6,0,1,0,2,7,2
Malcolm Thomas,2013,PF,24,CHI,3,0,6,1,2,.500,0,0,,1,2,.500,.500,1,5,.200,4,0,4,0,0,0,0,0,3
Klay Thompson,2013,SG,22,GSW,12,12,495,76,174,.437,25,59,.424,51,115,.443,.509,5,6,.833,9,46,55,22,12,7,24,44,182
Anthony Tolliver,2013,SF,27,ATL,6,0,68,8,14,.571,7,11,.636,1,3,.333,.821,1,3,.333,3,6,9,1,1,1,1,7,24
Ronny Turiaf,2013,C,30,LAC,5,0,59,7,10,.700,0,0,,7,10,.700,.700,2,4,.500,4,4,8,0,1,3,2,14,16
Ekpe Udoh,2013,C,25,MIL,4,0,54,4,9,.444,0,0,,4,9,.444,.444,0,0,,3,3,6,1,2,2,0,4,8
Dwyane Wade,2013,SG,31,MIA,22,22,782,144,315,.457,1,4,.250,143,311,.460,.459,60,80,.750,38,64,102,105,38,23,58,45,349
Gerald Wallace,2013,SF,30,BRK,7,7,243,31,67,.463,11,29,.379,20,38,.526,.545,11,20,.550,5,23,28,17,8,5,9,20,84
C.J. Watson,2013,PG,28,BRK,7,0,161,24,55,.436,4,15,.267,20,40,.500,.473,8,12,.667,5,12,17,13,5,1,1,11,60
David West,2013,PF,32,IND,19,19,689,115,249,.462,0,3,.000,115,246,.467,.462,72,94,.766,41,103,144,39,13,15,45,54,302
Russell Westbrook,2013,PG,24,OKC,2,2,68,17,41,.415,2,9,.222,15,32,.469,.439,12,14,.857,1,12,13,14,6,0,8,5,48
James White,2013,SF,30,NYK,4,0,9,2,4,.500,0,2,.000,2,2,1.000,.500,0,0,,1,1,2,0,0,0,0,1,4
Chris Wilcox,2013,C,30,BOS,2,0,6,0,0,,0,0,,0,0,,,0,0,,0,2,2,0,0,0,0,0,0
Deron Williams,2013,PG,28,BRK,7,7,292,45,106,.425,17,43,.395,28,63,.444,.505,37,45,.822,1,21,22,59,7,4,21,17,144
Terrence Williams,2013,SF,25,BOS,5,0,48,2,10,.200,0,3,.000,2,7,.286,.200,1,2,.500,1,9,10,6,0,1,4,3,5
Metta World Peace,2013,SF,33,LAL,3,3,84,7,28,.250,2,14,.143,5,14,.357,.286,2,2,1.000,6,5,11,5,2,1,3,5,18
Tony Wroten,2013,SG,19,MEM,6,0,17,2,11,.182,0,2,.000,2,9,.222,.182,4,4,1.000,1,3,4,2,1,0,2,1,8
Sam Young,2013,SG,27,IND,15,0,130,9,24,.375,2,10,.200,7,14,.500,.417,6,8,.750,11,18,29,4,4,1,7,17,26
Steven Adams,2014,C,20,OKC,18,0,331,31,45,.689,0,0,,31,45,.689,.689,8,23,.348,22,52,74,4,1,24,10,48,70
LaMarcus Aldridge,2014,PF,28,POR,11,11,441,113,250,.452,2,3,.667,111,247,.449,.456,60,75,.800,30,87,117,16,7,18,19,40,288
Lavoy Allen,2014,PF,24,IND,4,0,15,2,4,.500,0,0,,2,4,.500,.500,0,0,,1,4,5,1,0,0,0,1,4
Ray Allen*,2014,SG,38,MIA,20,1,527,59,143,.413,33,85,.388,26,58,.448,.528,34,37,.919,13,54,67,32,14,4,24,41,185
Tony Allen,2014,SG,32,MEM,7,1,230,35,72,.486,0,7,.000,35,65,.538,.486,16,21,.762,23,31,54,10,12,1,12,23,86
Chris Andersen,2014,C,35,MIA,18,0,317,33,57,.579,0,1,.000,33,56,.589,.579,26,38,.684,26,81,107,5,5,18,9,34,92
Alan Anderson,2014,SF,31,BRK,12,2,261,25,62,.403,9,31,.290,16,31,.516,.476,12,18,.667,10,22,32,15,10,0,10,32,71
Pero AntiÄ,2014,C,31,ATL,7,7,170,7,42,.167,3,25,.120,4,17,.235,.202,5,8,.625,10,17,27,5,5,3,8,26,22
Trevor Ariza,2014,SF,28,WAS,11,11,407,52,108,.481,25,56,.446,27,52,.519,.597,21,27,.778,21,77,98,19,17,4,14,26,150
Hilton Armstrong,2014,C,29,GSW,7,0,17,4,8,.500,0,1,.000,4,7,.571,.500,0,2,.000,3,1,4,2,0,2,4,6,8
Ãmer AÅÄ±k,2014,C,27,HOU,6,4,163,16,33,.485,0,0,,16,33,.485,.485,3,3,1.000,21,28,49,4,3,4,11,29,35
D.J. Augustin,2014,PG,26,CHI,5,0,141,21,72,.292,7,26,.269,14,46,.304,.340,17,19,.895,4,4,8,24,3,0,9,16,66
Jeff Ayres,2014,PF,26,SAS,17,0,65,6,13,.462,0,0,,6,13,.462,.462,5,8,.625,6,13,19,5,0,0,1,6,17
Harrison Barnes,2014,SF,21,GSW,7,0,156,19,48,.396,8,21,.381,11,27,.407,.479,9,16,.563,7,21,28,8,1,3,5,13,55
Matt Barnes,2014,SF,33,LAC,13,13,404,45,107,.421,19,60,.317,26,47,.553,.509,13,19,.684,22,36,58,23,12,3,17,41,122
Will Barton,2014,SG,23,POR,7,0,81,17,34,.500,6,11,.545,11,23,.478,.588,5,6,.833,5,7,12,3,1,2,6,7,45
Shane Battier,2014,SF,35,MIA,16,6,202,12,26,.462,9,20,.450,3,6,.500,.635,4,5,.800,1,9,10,5,5,1,5,23,37
Nicolas Batum,2014,SF,25,POR,11,11,459,67,142,.472,21,60,.350,46,82,.561,.546,12,15,.800,10,74,84,53,14,5,28,21,167
Aron Baynes,2014,C,27,SAS,14,0,101,12,24,.500,0,1,.000,12,23,.522,.500,8,10,.800,12,19,31,0,3,0,7,15,32
Bradley Beal,2014,SG,20,WAS,11,11,458,75,177,.424,22,53,.415,53,124,.427,.486,39,49,.796,15,40,55,50,18,7,23,31,211
Michael Beasley,2014,SF,25,MIA,4,0,23,5,10,.500,0,0,,5,10,.500,.500,1,3,.333,2,2,4,2,0,0,1,3,11
Marco Belinelli,2014,SF,27,SAS,23,0,356,44,99,.444,16,38,.421,28,61,.459,.525,21,22,.955,4,48,52,19,3,0,12,23,125
Patrick Beverley,2014,PG,25,HOU,6,6,202,19,50,.380,7,22,.318,12,28,.429,.450,7,10,.700,13,12,25,11,3,2,4,21,52
Bismack Biyombo,2014,C,21,CHA,3,1,48,3,5,.600,0,0,,3,5,.600,.600,2,6,.333,5,6,11,1,0,2,0,4,8
DeJuan Blair,2014,PF,24,DAL,6,0,81,16,27,.593,0,0,,16,27,.593,.593,8,13,.615,14,23,37,1,12,0,5,14,40
Steve Blake,2014,PG,33,GSW,6,0,45,4,12,.333,3,10,.300,1,2,.500,.458,0,1,.000,1,3,4,2,0,0,2,2,11
Andray Blatche,2014,PF,27,BRK,12,0,172,26,58,.448,0,2,.000,26,56,.464,.448,25,30,.833,25,35,60,4,6,2,10,22,77
Matt Bonner,2014,PF,33,SAS,22,2,136,10,21,.476,4,12,.333,6,9,.667,.571,3,4,.750,2,12,14,11,2,1,2,12,27
Trevor Booker,2014,PF,26,WAS,9,1,146,13,29,.448,0,2,.000,13,27,.481,.448,4,6,.667,16,23,39,8,2,9,3,25,30
Carlos Boozer,2014,PF,32,CHI,5,5,121,20,47,.426,0,0,,20,47,.426,.426,8,9,.889,8,31,39,5,1,0,7,13,48
Chris Bosh*,2014,C,29,MIA,20,20,686,116,229,.507,30,74,.405,86,155,.555,.572,36,48,.750,24,88,112,21,17,20,14,51,298
Elton Brand,2014,C,34,ATL,7,0,81,2,12,.167,0,0,,2,12,.167,.167,4,5,.800,7,16,23,6,1,6,0,10,8
Reggie Bullock,2014,SF,22,LAC,2,0,5,1,1,1.000,0,0,,1,1,1.000,1.000,0,0,,0,0,0,1,0,0,0,0,2
Caron Butler,2014,SF,33,OKC,18,2,419,35,108,.324,21,59,.356,14,49,.286,.421,22,28,.786,11,47,58,15,5,2,11,33,113
Jimmy Butler,2014,SG,24,CHI,5,5,218,22,57,.386,6,20,.300,16,37,.432,.439,18,23,.783,6,20,26,11,6,0,3,13,68
Rasual Butler,2014,SG,34,IND,11,0,70,6,15,.400,5,12,.417,1,3,.333,.567,2,2,1.000,0,6,6,1,1,1,1,3,19
JosÃ© CalderÃ³n,2014,PG,32,DAL,7,7,191,30,65,.462,11,23,.478,19,42,.452,.546,1,1,1.000,2,7,9,31,1,0,7,16,72
DeMarre Carroll,2014,SF,27,ATL,7,7,246,23,49,.469,9,22,.409,14,27,.519,.561,7,11,.636,12,22,34,11,5,3,8,21,62
Vince Carter,2014,SG,37,DAL,7,0,190,31,68,.456,15,31,.484,16,37,.432,.566,11,14,.786,7,18,25,17,3,2,6,12,88
Mario Chalmers,2014,PG,27,MIA,20,19,535,47,111,.423,15,43,.349,32,68,.471,.491,19,25,.760,2,44,46,72,19,6,30,48,128
Victor Claver,2014,SF,25,POR,2,0,7,0,0,,0,0,,0,0,,,0,4,.000,0,5,5,0,0,0,1,0,0
Norris Cole,2014,PG,25,MIA,20,0,404,32,78,.410,15,40,.375,17,38,.447,.506,13,15,.867,1,21,22,36,9,1,19,34,92
Darren Collison,2014,PG,26,LAC,13,0,249,35,90,.389,1,12,.083,34,78,.436,.394,39,45,.867,10,17,27,31,6,1,12,17,110
Nick Collison,2014,PF,33,OKC,17,2,183,12,29,.414,2,5,.400,10,24,.417,.448,7,10,.700,12,26,38,13,4,7,6,28,33
Mike Conley,2014,PG,26,MEM,7,7,267,44,102,.431,3,27,.111,41,75,.547,.446,20,26,.769,5,27,32,55,14,1,15,14,111
Chris Copeland,2014,SF,29,IND,12,0,82,12,28,.429,6,16,.375,6,12,.500,.536,6,9,.667,1,4,5,1,3,3,5,13,36
Jamal Crawford,2014,SG,33,LAC,13,0,313,68,171,.398,27,79,.342,41,92,.446,.477,39,44,.886,5,14,19,26,12,2,15,24,202
Jordan Crawford,2014,SG,25,GSW,6,0,57,12,33,.364,2,7,.286,10,26,.385,.394,11,14,.786,4,5,9,2,1,0,5,7,37
Jae Crowder,2014,SF,23,DAL,7,0,81,8,18,.444,3,7,.429,5,11,.455,.528,0,0,,4,8,12,2,2,1,3,13,19
Stephen Curry,2014,PG,25,GSW,7,7,296,51,116,.440,22,57,.386,29,59,.492,.534,37,42,.881,4,21,25,59,12,1,26,18,161
Samuel Dalembert,2014,C,32,DAL,7,7,135,11,24,.458,0,0,,11,24,.458,.458,10,15,.667,23,36,59,0,2,10,4,15,32
Troy Daniels,2014,SG,22,HOU,4,0,68,9,17,.529,8,15,.533,1,2,.500,.765,5,5,1.000,3,6,9,1,2,0,2,10,31
Ed Davis,2014,PF,24,MEM,7,0,25,3,10,.300,0,0,,3,10,.300,.300,0,1,.000,8,7,15,0,1,3,2,2,6
Glen Davis,2014,PF,28,LAC,13,0,158,25,41,.610,0,0,,25,41,.610,.610,0,0,,14,22,36,9,3,3,7,24,50
Austin Daye,2014,SF,25,SAS,1,0,6,0,2,.000,0,0,,0,2,.000,.000,0,0,,0,1,1,0,0,0,0,0,0
Nando De Colo,2014,SF,26,TOR,1,0,4,0,0,,0,0,,0,0,,,0,0,,0,1,1,0,0,0,0,2,0
DeMar DeRozan,2014,SG,24,TOR,7,7,282,45,117,.385,6,18,.333,39,99,.394,.410,71,79,.899,3,26,29,25,8,2,18,23,167
Boris Diaw,2014,PF,31,SAS,23,3,604,80,160,.500,18,45,.400,62,115,.539,.556,33,48,.688,25,86,111,78,14,3,29,44,211
Toney Douglas,2014,PG,27,MIA,10,0,29,3,9,.333,3,6,.500,0,3,.000,.500,1,2,.500,1,3,4,5,0,0,1,3,10
Chris Douglas-Roberts,2014,SF,27,CHA,4,0,70,11,16,.688,4,8,.500,7,8,.875,.813,12,14,.857,2,6,8,2,0,0,4,11,38
Jared Dudley,2014,SF,28,LAC,7,0,45,3,11,.273,3,6,.500,0,5,.000,.409,0,0,,0,6,6,2,1,0,0,5,9
Tim Duncan*,2014,C,37,SAS,23,23,752,149,285,.523,0,2,.000,149,283,.527,.523,76,100,.760,65,146,211,45,7,29,26,52,374
Mike Dunleavy,2014,SF,33,CHI,5,5,163,25,53,.472,12,26,.462,13,27,.481,.585,4,6,.667,5,13,18,12,3,1,5,7,66
Kevin Durant,2014,SF,25,OKC,19,19,815,194,422,.460,43,125,.344,151,297,.508,.511,132,163,.810,25,145,170,75,19,25,72,41,563
Wayne Ellington,2014,SG,26,DAL,2,0,14,2,6,.333,2,6,.333,0,0,,.500,2,2,1.000,0,2,2,2,0,0,2,1,8
Monta Ellis,2014,SG,28,DAL,7,7,249,52,127,.409,12,34,.353,40,93,.430,.457,27,31,.871,6,11,17,20,9,1,15,19,143
Landry Fields,2014,SF,25,TOR,3,0,26,0,2,.000,0,0,,0,2,.000,.000,0,0,,2,5,7,1,4,1,1,2,0
Derek Fisher,2014,SG,39,OKC,19,0,299,23,73,.315,12,41,.293,11,32,.344,.397,15,15,1.000,6,27,33,16,13,0,6,27,73
Jamaal Franklin,2014,SG,22,MEM,2,0,4,0,2,.000,0,0,,0,2,.000,.000,1,2,.500,0,1,1,0,0,0,0,0,1
Joel Freeland,2014,C,26,POR,9,0,24,0,3,.000,0,0,,0,3,.000,.000,1,2,.500,4,4,8,1,1,1,4,7,1
Francisco GarcÃ­a,2014,SF,32,HOU,2,0,22,2,6,.333,0,3,.000,2,3,.667,.333,3,4,.750,1,1,2,0,0,0,0,3,7
Kevin Garnett*,2014,C,37,BRK,12,12,250,33,63,.524,0,2,.000,33,61,.541,.524,17,23,.739,19,57,76,16,9,5,13,25,83
Marc Gasol,2014,C,29,MEM,7,7,299,47,116,.405,0,1,.000,47,115,.409,.405,27,34,.794,13,41,54,31,12,6,12,27,121
Paul George,2014,SF,23,IND,19,19,781,138,315,.438,52,129,.403,86,186,.462,.521,101,128,.789,13,132,145,73,41,7,49,56,429
Taj Gibson,2014,PF,28,CHI,5,0,154,32,57,.561,0,0,,32,57,.561,.561,27,36,.750,21,10,31,2,2,12,8,12,91
Manu GinÃ³bili*,2014,SG,36,SAS,23,0,586,104,237,.439,41,105,.390,63,132,.477,.525,81,94,.862,9,66,75,95,36,2,52,60,330
Drew Gooden,2014,C,32,WAS,10,0,146,14,38,.368,0,4,.000,14,34,.412,.368,6,8,.750,20,22,42,4,3,4,4,30,34
Marcin Gortat,2014,C,29,WAS,11,11,382,58,118,.492,0,0,,58,118,.492,.492,27,41,.659,36,73,109,16,5,14,20,22,143
Danny Granger,2014,SF,30,LAC,13,0,134,11,40,.275,5,22,.227,6,18,.333,.338,7,9,.778,2,18,20,3,6,1,3,24,34
Danny Green,2014,SG,26,SAS,23,23,529,78,159,.491,48,101,.475,30,58,.517,.642,9,11,.818,9,60,69,21,32,17,20,50,213
Draymond Green,2014,SF,23,GSW,7,4,228,28,60,.467,8,29,.276,20,31,.645,.533,19,24,.792,18,40,58,20,12,12,17,33,83
Willie Green,2014,SG,32,LAC,5,0,19,1,5,.200,1,4,.250,0,1,.000,.300,2,2,1.000,0,7,7,1,3,0,1,3,5
Blake Griffin,2014,PF,24,LAC,13,13,478,117,234,.500,1,7,.143,116,227,.511,.502,71,96,.740,35,61,96,50,16,14,31,54,306
Jorge GutiÃ©rrez,2014,PG,25,BRK,2,0,3,0,0,,0,0,,0,0,,,2,4,.500,1,0,1,0,0,0,0,0,2
Tyler Hansbrough,2014,PF,28,TOR,3,0,29,1,3,.333,0,0,,1,3,.333,.333,5,6,.833,2,4,6,1,0,0,2,8,7
James Harden,2014,SG,24,HOU,6,6,263,50,133,.376,16,54,.296,34,79,.430,.436,45,50,.900,5,23,28,35,12,1,21,21,161
Al Harrington,2014,PF,33,WAS,7,0,59,6,15,.400,0,7,.000,6,8,.750,.400,5,7,.714,1,15,16,0,3,0,4,14,17
Devin Harris,2014,PG,30,DAL,7,0,176,31,66,.470,11,25,.440,20,41,.488,.553,7,8,.875,1,16,17,27,2,2,11,13,80
Udonis Haslem,2014,PF,33,MIA,16,6,169,17,37,.459,0,0,,17,37,.459,.459,6,10,.600,12,29,41,4,1,3,1,28,40
Chuck Hayes,2014,C,30,TOR,5,0,38,2,8,.250,0,0,,2,8,.250,.250,2,2,1.000,4,4,8,2,3,0,1,5,6
Gerald Henderson,2014,SG,26,CHA,4,4,119,14,37,.378,0,9,.000,14,28,.500,.378,11,17,.647,1,15,16,9,4,1,6,12,39
Roy Hibbert,2014,C,27,IND,19,19,542,66,147,.449,0,1,.000,66,146,.452,.449,44,57,.772,44,61,105,17,4,26,25,62,176
NenÃª,2014,PF,31,WAS,10,10,325,64,138,.464,0,0,,64,138,.464,.464,9,26,.346,8,45,53,26,9,11,17,36,137
George Hill,2014,PG,27,IND,19,19,687,79,178,.444,28,77,.364,51,101,.505,.522,44,61,.721,13,58,71,57,23,4,28,43,230
Solomon Hill,2014,SF,22,IND,1,0,1,0,0,,0,0,,0,0,,,0,0,,0,0,0,0,0,0,0,0,0
Kirk Hinrich,2014,PG,33,CHI,5,5,167,23,56,.411,7,19,.368,16,37,.432,.473,2,4,.500,1,14,15,22,4,1,11,22,55
Ryan Hollins,2014,PF,29,LAC,5,0,9,1,4,.250,0,0,,1,4,.250,.250,1,1,1.000,1,2,3,0,0,0,1,3,3
Dwight Howard,2014,C,28,HOU,6,6,231,58,106,.547,0,0,,58,106,.547,.547,40,64,.625,27,55,82,11,4,17,19,25,156
Serge Ibaka,2014,PF,24,OKC,17,17,581,87,147,.592,5,13,.385,82,134,.612,.609,26,34,.765,31,85,116,12,11,42,20,54,205
Andre Iguodala,2014,SF,30,GSW,7,7,248,32,62,.516,8,15,.533,24,47,.511,.581,20,33,.606,5,28,33,31,9,2,21,19,92
Reggie Jackson,2014,PG,23,OKC,19,4,531,75,161,.466,21,53,.396,54,108,.500,.531,39,44,.886,13,59,72,46,5,4,38,49,210
Bernard James,2014,C,28,DAL,2,0,8,0,0,,0,0,,0,0,,,0,0,,1,0,1,0,1,0,0,0,0
LeBron James,2014,PF,29,MIA,20,20,763,192,340,.565,35,86,.407,157,254,.618,.616,129,160,.806,14,127,141,95,36,11,61,46,548
Al Jefferson,2014,C,29,CHA,3,3,106,26,53,.491,0,0,,26,53,.491,.491,4,5,.800,6,22,28,2,1,5,1,7,56
Amir Johnson,2014,PF,26,TOR,7,7,191,34,52,.654,0,2,.000,34,50,.680,.654,9,12,.750,16,26,42,7,3,4,12,29,77
James Johnson,2014,SF,26,MEM,3,0,28,5,15,.333,2,5,.400,3,10,.300,.400,7,10,.700,4,2,6,0,1,0,0,3,19
Joe Johnson,2014,SG,32,BRK,12,12,469,98,184,.533,22,53,.415,76,131,.580,.592,36,43,.837,9,37,46,35,6,3,19,20,254
James Jones,2014,SF,33,MIA,15,0,126,18,40,.450,15,32,.469,3,8,.375,.638,2,3,.667,3,8,11,5,3,2,0,17,53
Perry Jones,2014,PF,22,OKC,11,0,55,7,18,.389,3,10,.300,4,8,.500,.472,0,0,,3,6,9,1,0,1,1,9,17
Terrence Jones,2014,PF,22,HOU,6,2,138,20,39,.513,0,1,.000,20,38,.526,.513,6,12,.500,17,20,37,8,5,3,2,13,46
DeAndre Jordan,2014,C,25,LAC,13,13,442,46,63,.730,0,0,,46,63,.730,.730,33,76,.434,43,120,163,10,12,33,23,45,125
Cory Joseph,2014,SG,22,SAS,17,0,87,17,35,.486,0,3,.000,17,32,.531,.486,14,18,.778,1,8,9,9,3,0,4,7,48
Michael Kidd-Gilchrist,2014,SF,20,CHA,4,4,91,14,27,.519,0,1,.000,14,26,.538,.519,6,10,.600,8,18,26,6,0,2,8,13,34
Andrei Kirilenko,2014,PF,32,BRK,10,0,144,7,15,.467,0,0,,7,15,.467,.467,11,17,.647,10,13,23,10,10,3,3,11,25
Kyle Korver,2014,SG,32,ATL,7,7,250,30,66,.455,23,54,.426,7,12,.583,.629,11,12,.917,2,35,37,5,4,2,11,15,94
Kosta Koufos,2014,C,24,MEM,7,0,45,7,16,.438,0,0,,7,16,.438,.438,4,4,1.000,7,8,15,2,2,3,3,7,18
Ognjen KuzmiÄ,2014,C,23,GSW,3,0,8,0,0,,0,0,,0,0,,,0,0,,1,3,4,0,0,0,0,2,0
Jeremy Lamb,2014,SG,21,OKC,11,0,100,17,42,.405,2,14,.143,15,28,.536,.429,4,4,1.000,4,12,16,7,7,1,3,8,40
Shane Larkin,2014,PG,21,DAL,2,0,10,0,3,.000,0,1,.000,0,2,.000,.000,0,0,,0,1,1,2,0,0,1,0,0
Courtney Lee,2014,SG,28,MEM,7,7,224,25,60,.417,6,19,.316,19,41,.463,.467,14,18,.778,3,11,14,11,5,2,6,20,70
David Lee,2014,PF,30,GSW,7,7,217,41,77,.532,0,0,,41,77,.532,.532,15,19,.789,24,40,64,18,4,0,17,28,97
Kawhi Leonard,2014,SF,22,SAS,23,23,736,122,239,.510,31,74,.419,91,165,.552,.575,53,72,.736,31,124,155,38,39,14,29,66,328
Meyers Leonard,2014,C,21,POR,4,0,9,0,2,.000,0,0,,0,2,.000,.000,0,0,,0,2,2,0,0,0,0,1,0
Jon Leuer,2014,PF,24,MEM,3,0,23,3,7,.429,1,2,.500,2,5,.400,.500,2,2,1.000,2,6,8,2,1,0,0,2,9
Rashard Lewis,2014,SF,34,MIA,18,8,319,35,85,.412,22,59,.373,13,26,.500,.541,3,4,.750,4,33,37,5,7,6,5,29,95
Damian Lillard,2014,PG,23,POR,11,11,466,83,189,.439,27,70,.386,56,119,.471,.511,59,66,.894,12,44,56,72,11,1,30,29,252
Jeremy Lin,2014,PG,25,HOU,6,0,177,25,61,.410,5,23,.217,20,38,.526,.451,13,16,.813,7,15,22,26,3,1,13,15,68
Shaun Livingston,2014,PG,28,BRK,12,10,325,44,86,.512,1,1,1.000,43,85,.506,.517,27,37,.730,8,34,42,40,5,5,22,41,116
Robin Lopez,2014,C,25,POR,11,11,367,43,88,.489,0,0,,43,88,.489,.489,24,36,.667,47,54,101,9,6,20,11,40,110
Kyle Lowry,2014,PG,27,TOR,7,7,271,44,109,.404,17,43,.395,27,66,.409,.482,43,49,.878,9,24,33,33,6,0,20,27,148
Shelvin Mack,2014,PG,23,ATL,7,0,118,19,47,.404,10,27,.370,9,20,.450,.511,9,12,.750,3,10,13,25,4,0,6,10,57
Ian Mahinmi,2014,C,27,IND,19,0,241,13,27,.481,0,0,,13,27,.481,.481,11,18,.611,22,23,45,3,5,16,10,38,37
Shawn Marion,2014,SF,35,DAL,7,7,193,24,59,.407,4,18,.222,20,41,.488,.441,7,11,.636,14,23,37,13,6,1,5,11,59
Cartier Martin,2014,SF,29,ATL,3,0,15,2,3,.667,0,0,,2,3,.667,.667,0,0,,1,2,3,0,2,0,1,2,4
Wesley Matthews,2014,SG,27,POR,11,11,426,56,136,.412,22,68,.324,34,68,.500,.493,26,32,.813,7,36,43,14,14,5,22,45,160
CJ McCollum,2014,SG,22,POR,6,0,24,1,11,.091,0,5,.000,1,6,.167,.091,2,2,1.000,0,1,1,0,0,0,1,2,4
Josh McRoberts,2014,PF,26,CHA,4,4,154,15,33,.455,8,17,.471,7,16,.438,.576,8,10,.800,1,26,27,15,4,1,6,13,46
Andre Miller,2014,SG,37,WAS,11,0,108,19,41,.463,1,3,.333,18,38,.474,.476,5,9,.556,2,9,11,9,3,0,8,12,44
Mike Miller,2014,SF,33,MEM,7,1,173,15,42,.357,14,29,.483,1,13,.077,.524,7,9,.778,2,24,26,9,6,0,5,16,51
Patty Mills,2014,PG,25,SAS,23,0,351,63,141,.447,32,79,.405,31,62,.500,.560,10,13,.769,3,32,35,33,17,1,14,31,168
Paul Millsap,2014,PF,28,ATL,7,7,267,41,103,.398,9,27,.333,32,76,.421,.442,45,56,.804,21,55,76,20,10,13,20,25,136
Nazr Mohammed,2014,C,36,CHI,2,0,5,0,1,.000,0,0,,0,1,.000,.000,0,0,,1,1,2,0,0,0,0,3,0
Mike Muscala,2014,PF,22,ATL,2,0,5,0,2,.000,0,0,,0,2,.000,.000,0,0,,0,0,0,0,0,0,0,0,0
Gary Neal,2014,SG,29,CHA,4,0,104,18,51,.353,4,18,.222,14,33,.424,.392,5,7,.714,3,5,8,4,0,0,8,9,45
Nemanja NedoviÄ,2014,SG,22,GSW,1,0,0,0,0,,0,0,,0,0,,,0,0,,0,0,0,0,0,0,0,1,0
Joakim Noah,2014,C,28,CHI,5,5,210,21,41,.512,0,0,,21,41,.512,.512,10,17,.588,15,49,64,23,5,7,19,19,52
Steve Novak,2014,PF,30,TOR,4,0,15,0,3,.000,0,3,.000,0,0,,.000,0,0,,0,5,5,1,0,0,0,0,0
Dirk Nowitzki,2014,PF,35,DAL,7,7,263,54,126,.429,1,12,.083,53,114,.465,.433,25,31,.806,5,51,56,11,6,6,15,20,134
Jermaine O'Neal,2014,PF,35,GSW,7,3,84,18,32,.563,0,0,,18,32,.563,.563,6,8,.750,12,12,24,1,1,3,4,12,42
Greg Oden,2014,C,26,MIA,3,0,7,0,0,,0,0,,0,0,,,0,0,,0,1,1,1,1,0,0,2,0
Jannero Pargo,2014,PG,34,CHA,1,0,3,0,0,,0,0,,0,0,,,0,0,,0,1,1,1,0,0,1,0,0
Tony Parker,2014,PG,31,SAS,23,23,719,168,346,.486,13,35,.371,155,311,.498,.504,51,70,.729,5,40,45,111,15,2,62,37,400
Chandler Parsons,2014,SF,25,HOU,6,6,250,46,105,.438,13,36,.361,33,69,.478,.500,11,15,.733,6,35,41,14,4,2,5,19,116
Patrick Patterson,2014,PF,24,TOR,7,0,199,26,48,.542,7,18,.389,19,30,.633,.615,14,18,.778,12,35,47,9,3,3,6,13,73
Chris Paul,2014,PG,28,LAC,13,13,472,92,197,.467,32,70,.457,60,127,.472,.548,41,53,.774,12,43,55,134,37,0,39,50,257
Kendrick Perkins,2014,C,29,OKC,19,19,384,24,45,.533,0,0,,24,45,.533,.533,12,15,.800,33,69,102,14,4,6,25,64,60
Paul Pierce*,2014,SF,36,BRK,12,12,368,60,129,.465,19,53,.358,41,76,.539,.539,25,32,.781,4,50,54,24,14,4,20,44,164
Mason Plumlee,2014,C,23,BRK,10,0,114,7,16,.438,0,0,,7,16,.438,.438,8,18,.444,5,18,23,2,3,7,9,24,22
Otto Porter Jr.,2014,SF,20,WAS,3,0,6,1,3,.333,0,1,.000,1,2,.500,.333,0,0,,0,0,0,0,0,0,0,0,2
Tayshaun Prince,2014,SF,33,MEM,7,6,113,10,26,.385,1,4,.250,9,22,.409,.404,0,0,,4,6,10,6,1,0,1,8,21
Zach Randolph,2014,PF,32,MEM,6,6,234,42,104,.404,0,1,.000,42,103,.408,.404,25,41,.610,17,35,52,14,5,1,10,13,109
J.J. Redick,2014,SG,29,LAC,13,13,351,61,133,.459,26,65,.400,35,68,.515,.556,25,26,.962,4,18,22,19,11,0,13,23,173
Luke Ridnour,2014,PG,32,CHA,4,0,36,4,13,.308,2,6,.333,2,7,.286,.385,0,0,,0,4,4,12,0,1,4,1,10
Andre Roberson,2014,SG,22,OKC,2,0,9,0,3,.000,0,0,,0,3,.000,.000,0,0,,0,2,2,0,0,0,0,0,0
Thomas Robinson,2014,PF,22,POR,11,0,122,13,31,.419,0,0,,13,31,.419,.419,6,7,.857,10,18,28,6,5,5,5,23,32
Terrence Ross,2014,SG,22,TOR,7,7,158,14,47,.298,4,24,.167,10,23,.435,.340,3,5,.600,1,13,14,2,6,3,8,19,35
John Salmons,2014,SG,34,TOR,6,0,77,5,17,.294,2,12,.167,3,5,.600,.353,1,1,1.000,0,6,6,5,2,0,1,9,13
Dennis SchrÃ¶der,2014,PG,20,ATL,2,0,7,2,2,1.000,1,1,1.000,1,1,1.000,1.250,0,0,,0,2,2,0,0,0,0,1,5
Luis Scola,2014,PF,33,IND,18,0,243,48,105,.457,1,3,.333,47,102,.461,.462,13,22,.591,11,31,42,9,6,3,7,29,110
Mike Scott,2014,PF,25,ATL,7,0,146,23,63,.365,10,31,.323,13,32,.406,.444,10,14,.714,3,15,18,3,1,0,2,11,66
Thabo Sefolosha,2014,SG,29,OKC,15,13,236,23,55,.418,6,23,.261,17,32,.531,.473,4,5,.800,7,24,31,10,10,0,7,10,56
Kevin SÃ©raphin,2014,C,24,WAS,4,0,6,0,3,.000,0,0,,0,3,.000,.000,0,0,,1,1,2,0,0,0,1,1,0
Donald Sloan,2014,SG,26,IND,4,0,15,2,7,.286,1,4,.250,1,3,.333,.357,2,4,.500,0,1,1,3,1,0,2,0,7
Tony Snell,2014,SG,22,CHI,5,0,46,2,9,.222,0,5,.000,2,4,.500,.222,0,0,,0,6,6,2,1,1,1,5,4
Marreese Speights,2014,C,26,GSW,7,0,68,19,36,.528,0,0,,19,36,.528,.528,6,12,.500,9,13,22,3,2,4,2,12,44
Tiago Splitter,2014,C,29,SAS,23,18,516,61,100,.610,0,1,.000,61,99,.616,.610,51,71,.718,45,95,140,46,16,11,18,53,173
Lance Stephenson,2014,SG,23,IND,19,19,705,100,220,.455,24,67,.358,76,153,.497,.509,35,49,.714,24,107,131,80,16,4,46,55,259
Jeff Teague,2014,PG,25,ATL,7,7,242,44,112,.393,9,27,.333,35,85,.412,.433,38,40,.950,5,21,26,35,7,4,21,15,135
Mirza TeletoviÄ,2014,SF,28,BRK,12,0,220,36,82,.439,19,56,.339,17,26,.654,.555,8,12,.667,15,25,40,3,5,2,5,14,99
Garrett Temple,2014,SG,27,WAS,10,0,9,2,2,1.000,1,1,1.000,1,1,1.000,1.250,0,0,,0,0,0,0,0,0,1,5,5
Hasheem Thabeet,2014,C,26,OKC,2,0,7,0,0,,0,0,,0,0,,,0,0,,0,0,0,0,0,0,0,4,0
Klay Thompson,2014,SG,23,GSW,7,7,257,40,98,.408,16,44,.364,24,54,.444,.490,19,24,.792,4,20,24,25,7,5,15,24,115
Marcus Thornton,2014,SG,26,BRK,10,0,124,21,54,.389,5,21,.238,16,33,.485,.435,12,18,.667,7,12,19,1,2,1,2,4,59
Anthony Tolliver,2014,PF,28,CHA,4,0,21,1,2,.500,1,2,.500,0,0,,.750,3,3,1.000,1,3,4,1,0,0,0,2,6
Hedo TÃ¼rkoÄlu,2014,SF,34,LAC,5,0,41,6,13,.462,4,10,.400,2,3,.667,.615,0,0,,0,5,5,1,3,0,0,3,16
Evan Turner,2014,SF,25,IND,12,0,149,15,35,.429,4,7,.571,11,28,.393,.486,5,5,1.000,0,26,26,19,4,0,11,9,39
Beno Udrih,2014,SG,31,MEM,7,0,115,21,45,.467,4,12,.333,17,33,.515,.511,9,13,.692,2,10,12,12,3,0,9,11,55
Jonas ValanÄiÅ«nas,2014,C,21,TOR,7,7,200,31,49,.633,0,0,,31,49,.633,.633,14,22,.636,19,49,68,2,0,7,19,22,76
Greivis VÃ¡squez,2014,PG,27,TOR,7,0,190,27,64,.422,10,27,.370,17,37,.459,.500,7,9,.778,3,23,26,36,4,1,10,22,71
Dwyane Wade,2014,SG,32,MIA,20,20,693,139,278,.500,9,24,.375,130,254,.512,.516,69,90,.767,16,61,77,77,30,5,54,55,356
Kemba Walker,2014,PG,23,CHA,4,4,153,26,55,.473,12,24,.500,14,31,.452,.582,14,18,.778,1,14,15,24,8,3,15,6,78
John Wall,2014,PG,23,WAS,11,11,420,60,164,.366,7,32,.219,53,132,.402,.387,52,68,.765,5,39,44,78,18,8,36,29,179
C.J. Watson,2014,PG,29,IND,19,0,342,37,90,.411,16,40,.400,21,50,.420,.500,17,28,.607,3,37,40,18,16,1,14,28,107
Earl Watson,2014,PG,34,POR,4,0,14,0,1,.000,0,1,.000,0,0,,.000,0,0,,0,1,1,1,0,0,1,1,0
Martell Webster,2014,SF,27,WAS,11,0,195,15,41,.366,6,26,.231,9,15,.600,.439,6,9,.667,4,21,25,5,4,5,4,14,42
David West,2014,PF,33,IND,19,19,687,121,245,.494,2,10,.200,119,235,.506,.498,43,61,.705,24,104,128,75,14,15,43,57,287
Russell Westbrook,2014,PG,25,OKC,19,19,735,167,398,.420,28,100,.280,139,298,.466,.455,145,164,.884,45,93,138,153,41,6,83,62,507
D.J. White,2014,PF,27,CHA,1,0,3,0,0,,0,0,,0,0,,,0,0,,0,2,2,0,0,0,1,0,0
Deron Williams,2014,PG,29,BRK,12,12,428,60,152,.395,18,53,.340,42,99,.424,.454,36,45,.800,7,31,38,70,13,2,27,31,174
Lou Williams,2014,PG,27,ATL,7,0,133,19,50,.380,5,16,.313,14,34,.412,.430,15,16,.938,0,16,16,8,7,1,13,10,58
Mo Williams,2014,PG,31,POR,8,0,187,22,59,.373,5,21,.238,17,38,.447,.415,10,11,.909,2,10,12,15,3,0,14,24,59
Brandan Wright,2014,C,26,DAL,6,0,90,15,18,.833,0,0,,15,18,.833,.833,3,6,.500,5,7,12,8,2,6,2,8,33
Dorell Wright,2014,SF,28,POR,8,0,88,7,19,.368,4,12,.333,3,7,.429,.474,11,15,.733,2,14,16,3,3,9,5,8,29
Cody Zeller,2014,C,21,CHA,4,0,53,3,9,.333,0,0,,3,9,.333,.333,2,4,.500,5,4,9,2,0,3,2,3,8
Jordan Adams,2015,SG,20,MEM,4,0,10,2,3,.667,1,1,1.000,1,2,.500,.833,2,4,.500,0,1,1,0,1,0,0,0,7
Arron Afflalo,2015,SG,29,POR,3,3,60,2,12,.167,1,4,.250,1,8,.125,.208,0,1,.000,0,7,7,2,0,0,3,6,5
Alexis AjinÃ§a,2015,C,26,NOP,3,0,10,4,4,1.000,0,0,,4,4,1.000,1.000,0,0,,0,1,1,1,1,0,0,2,8
LaMarcus Aldridge,2015,PF,29,POR,5,5,208,37,112,.330,3,11,.273,34,101,.337,.344,32,36,.889,21,35,56,9,2,12,8,16,109
Tony Allen,2015,SG,33,MEM,10,9,279,28,57,.491,1,7,.143,27,50,.540,.500,9,12,.750,14,38,52,15,24,11,13,27,66
Al-Farouq Aminu,2015,SF,24,DAL,5,2,150,17,31,.548,7,11,.636,10,20,.500,.661,15,19,.789,14,22,36,6,10,8,6,15,56
Alan Anderson,2015,SG,32,BRK,6,0,142,25,41,.610,10,16,.625,15,25,.600,.732,6,9,.667,2,19,21,7,4,1,8,9,66
Ryan Anderson,2015,PF,26,NOP,4,0,95,16,36,.444,5,12,.417,11,24,.458,.514,6,6,1.000,7,10,17,9,0,2,4,12,43
Giannis Antetokounmpo,2015,SG,20,MIL,6,6,201,26,71,.366,0,1,.000,26,70,.371,.366,17,23,.739,12,30,42,16,3,9,11,18,69
Pero AntiÄ,2015,C,32,ATL,15,1,199,16,50,.320,11,32,.344,5,18,.278,.430,20,25,.800,9,34,43,4,2,3,5,38,63
Trevor Ariza,2015,SF,29,HOU,17,17,655,75,176,.426,36,96,.375,39,80,.488,.528,38,42,.905,18,91,109,44,30,2,23,51,224
Ãmer AÅÄ±k,2015,C,28,NOP,4,4,79,2,10,.200,0,0,,2,10,.200,.200,4,7,.571,12,17,29,6,5,0,5,10,8
Jeff Ayres,2015,PF,27,SAS,3,0,12,0,1,.000,0,0,,0,1,.000,.000,0,0,,0,3,3,2,0,0,0,0,0
Leandro Barbosa,2015,SG,32,GSW,21,0,229,39,88,.443,8,23,.348,31,65,.477,.489,18,22,.818,8,19,27,18,6,1,12,24,104
J.J. Barea,2015,PG,30,DAL,5,2,154,25,57,.439,4,16,.250,21,41,.512,.474,5,6,.833,5,19,24,37,4,0,14,17,59
Harrison Barnes,2015,SF,22,GSW,21,21,681,88,200,.440,22,62,.355,66,138,.478,.495,25,34,.735,45,65,110,32,17,11,22,45,223
Matt Barnes,2015,SF,34,LAC,14,14,409,38,100,.380,16,60,.267,22,40,.550,.460,15,20,.750,16,55,71,22,20,10,16,54,107
Brandon Bass,2015,PF,29,BOS,4,4,86,7,20,.350,0,0,,7,20,.350,.350,6,10,.600,3,5,8,10,1,3,3,4,20
Nicolas Batum,2015,SF,26,POR,5,5,209,24,70,.343,13,39,.333,11,31,.355,.436,10,13,.769,6,37,43,26,1,1,12,11,71
Jerryd Bayless,2015,PG,26,MIL,6,0,120,12,35,.343,2,7,.286,10,28,.357,.371,13,17,.765,4,11,15,18,2,2,4,12,39
Aron Baynes,2015,C,28,SAS,4,0,40,3,10,.300,0,0,,3,10,.300,.300,3,3,1.000,3,7,10,1,0,0,3,9,9
Kent Bazemore,2015,SG,25,ATL,16,2,303,30,71,.423,6,28,.214,24,43,.558,.465,21,31,.677,3,50,53,13,11,9,11,25,87
Bradley Beal,2015,SG,21,WAS,10,10,418,81,200,.405,23,63,.365,58,137,.423,.463,49,59,.831,14,41,55,46,16,7,26,19,234
Marco Belinelli,2015,SG,28,SAS,7,0,116,20,39,.513,14,30,.467,6,9,.667,.692,11,13,.846,2,11,13,10,2,0,5,10,65
Steve Blake,2015,PG,34,POR,5,0,43,2,11,.182,1,8,.125,1,3,.333,.227,2,2,1.000,0,1,1,8,0,1,2,4,7
Bojan BogdanoviÄ,2015,SF,25,BRK,6,5,206,23,59,.390,11,33,.333,12,26,.462,.483,5,7,.714,3,20,23,10,4,2,8,12,62
Andrew Bogut,2015,C,30,GSW,19,18,440,42,75,.560,0,1,.000,42,74,.568,.560,5,13,.385,41,112,153,36,11,34,26,69,89
Matt Bonner,2015,PF,34,SAS,7,0,36,2,10,.200,2,9,.222,0,1,.000,.300,0,0,,0,6,6,1,0,1,1,8,6
Avery Bradley,2015,SG,24,BOS,4,4,133,19,50,.380,5,19,.263,14,31,.452,.430,6,7,.857,3,12,15,3,3,0,3,13,49
Elton Brand,2015,C,35,ATL,3,0,4,0,1,.000,0,0,,0,1,.000,.000,1,2,.500,0,1,1,0,0,0,0,3,1
Corey Brewer,2015,SF,28,HOU,17,0,428,72,167,.431,12,42,.286,60,125,.480,.467,35,55,.636,11,36,47,19,11,4,15,48,191
Aaron Brooks,2015,PG,30,CHI,12,0,132,21,61,.344,8,26,.308,13,35,.371,.410,4,7,.571,3,15,18,11,3,1,9,16,54
Markel Brown,2015,SG,23,BRK,2,1,10,2,5,.400,0,2,.000,2,3,.667,.400,2,2,1.000,2,0,2,1,0,0,2,0,6
Jimmy Butler,2015,SG,25,CHI,12,12,506,94,213,.441,28,72,.389,66,141,.468,.507,59,72,.819,18,49,67,38,29,9,21,27,275
Rasual Butler,2015,SF,35,WAS,2,0,7,0,1,.000,0,1,.000,0,0,,.000,0,0,,0,1,1,1,0,0,0,2,0
Will Bynum,2015,SG,32,WAS,3,0,31,7,14,.500,1,2,.500,6,12,.500,.536,4,5,.800,2,1,3,3,2,1,5,6,19
Nick Calathes,2015,SG,25,MEM,9,3,126,12,36,.333,6,13,.462,6,23,.261,.417,3,8,.375,1,15,16,16,9,1,10,15,33
Clint Capela,2015,C,20,HOU,17,0,127,21,31,.677,0,0,,21,31,.677,.677,15,29,.517,13,29,42,5,3,9,3,19,57
DeMarre Carroll,2015,SF,28,ATL,16,16,558,86,177,.486,29,72,.403,57,105,.543,.568,32,41,.780,26,71,97,32,18,5,15,36,233
Vince Carter,2015,SG,38,MEM,11,0,196,27,67,.403,7,28,.250,20,39,.513,.455,8,9,.889,13,34,47,11,7,2,7,17,69
Michael Carter-Williams,2015,PG,23,MIL,6,6,191,33,78,.423,0,5,.000,33,73,.452,.423,7,12,.583,1,26,27,29,7,6,16,14,73
Tyson Chandler,2015,C,32,DAL,5,5,160,19,29,.655,0,0,,19,29,.655,.655,13,26,.500,27,27,54,1,3,6,5,16,51
Earl Clark,2015,PF,27,BRK,2,0,13,2,10,.200,2,3,.667,0,7,.000,.300,0,0,,0,2,2,0,1,0,0,1,6
Norris Cole,2015,PG,26,NOP,4,0,106,15,36,.417,3,14,.214,12,22,.545,.458,2,3,.667,1,6,7,7,0,1,8,15,35
Mike Conley,2015,PG,27,MEM,8,8,243,41,96,.427,10,33,.303,31,63,.492,.479,23,28,.821,0,9,9,40,11,0,12,10,115
Allen Crabbe,2015,SG,22,POR,2,1,39,4,5,.800,2,2,1.000,2,3,.667,1.000,0,0,,0,3,3,1,2,1,1,1,10
Jamal Crawford,2015,SG,34,LAC,14,0,379,67,186,.360,18,74,.243,49,112,.438,.409,26,30,.867,6,24,30,27,13,3,17,34,178
Jae Crowder,2015,SF,24,BOS,4,1,100,15,29,.517,3,10,.300,12,19,.632,.569,10,13,.769,8,12,20,8,4,3,5,14,43
Dante Cunningham,2015,PF,27,NOP,4,0,75,9,11,.818,0,0,,9,11,.818,.818,3,3,1.000,4,14,18,2,3,4,0,7,21
Stephen Curry,2015,PG,26,GSW,21,21,826,200,439,.456,98,232,.422,102,207,.493,.567,96,115,.835,20,85,105,134,39,3,82,47,594
Gigi Datome,2015,SF,27,BOS,3,0,14,2,6,.333,0,2,.000,2,4,.500,.333,0,0,,0,1,1,1,0,0,0,4,4
Anthony Davis,2015,PF,21,NOP,4,4,172,47,87,.540,0,2,.000,47,85,.553,.540,32,36,.889,9,35,44,8,5,12,13,12,126
Glen Davis,2015,PF,29,LAC,14,0,144,17,38,.447,0,1,.000,17,37,.459,.447,7,9,.778,9,18,27,3,5,5,9,33,41
Matthew Dellavedova,2015,SG,24,CLE,20,7,497,47,136,.346,24,76,.316,23,60,.383,.434,25,32,.781,10,31,41,53,9,0,35,52,143
DeMar DeRozan,2015,SG,25,TOR,4,4,159,32,80,.400,3,8,.375,29,72,.403,.419,14,17,.824,5,20,25,23,6,0,10,12,81
Boris Diaw,2015,PF,32,SAS,7,0,198,34,71,.479,4,18,.222,30,53,.566,.507,9,13,.692,13,30,43,25,5,3,9,24,81
Joey Dorsey,2015,PF,31,HOU,6,0,13,0,2,.000,0,0,,0,2,.000,.000,1,2,.500,1,3,4,2,0,0,1,2,1
Jared Dudley,2015,SG,29,MIL,6,0,110,14,30,.467,8,14,.571,6,16,.375,.600,4,7,.571,3,8,11,8,12,2,5,12,40
Tim Duncan*,2015,C,38,SAS,7,7,250,53,90,.589,0,1,.000,53,89,.596,.589,19,34,.559,19,59,78,23,9,10,7,26,125
Mike Dunleavy,2015,SF,34,CHI,12,12,389,43,88,.489,27,56,.482,16,32,.500,.642,18,19,.947,7,41,48,31,10,5,15,31,131
Monta Ellis,2015,SG,29,DAL,5,5,197,52,111,.468,11,30,.367,41,81,.506,.518,15,20,.750,4,12,16,26,10,3,16,18,130
Tyler Ennis,2015,PG,20,MIL,1,0,16,2,9,.222,1,5,.200,1,4,.250,.278,0,0,,3,1,4,3,0,0,0,1,5
Tyreke Evans,2015,SG,25,NOP,4,4,125,14,43,.326,2,11,.182,12,32,.375,.349,10,17,.588,3,17,20,20,5,1,6,10,40
Festus Ezeli,2015,C,25,GSW,20,0,183,27,50,.540,0,0,,27,50,.540,.540,16,29,.552,24,38,62,6,1,10,12,25,70
Raymond Felton,2015,PG,30,DAL,3,1,36,4,15,.267,0,4,.000,4,11,.364,.267,3,3,1.000,1,6,7,4,0,0,0,1,11
Tim Frazier,2015,PG,24,POR,2,0,3,0,1,.000,0,0,,0,1,.000,.000,0,0,,0,0,0,0,0,0,1,0,0
Joel Freeland,2015,C,27,POR,2,0,7,0,0,,0,0,,0,0,,,0,0,,0,1,1,0,1,0,0,0,0
Marc Gasol,2015,C,30,MEM,11,11,416,71,180,.394,0,2,.000,71,178,.399,.394,75,88,.852,19,94,113,49,10,19,16,33,217
Pau Gasol,2015,PF,34,CHI,10,10,317,56,115,.487,0,4,.000,56,111,.505,.487,32,42,.762,17,77,94,31,5,21,21,18,144
Alonzo Gee,2015,SF,27,POR,1,0,3,0,0,,0,0,,0,0,,,0,0,,0,1,1,1,0,0,0,0,0
Taj Gibson,2015,PF,29,CHI,12,2,276,34,72,.472,0,0,,34,72,.472,.472,21,30,.700,25,41,66,12,4,12,11,25,89
Manu GinÃ³bili*,2015,SG,37,SAS,7,0,131,15,43,.349,8,22,.364,7,21,.333,.442,18,23,.783,4,20,24,32,4,6,14,19,56
Drew Gooden,2015,PF,33,WAS,10,0,178,23,61,.377,12,26,.462,11,35,.314,.475,10,13,.769,13,42,55,8,2,10,14,21,68
Eric Gordon,2015,SG,26,NOP,4,4,143,28,64,.438,13,32,.406,15,32,.469,.539,5,6,.833,3,7,10,15,2,2,10,11,74
Marcin Gortat,2015,C,30,WAS,10,10,307,54,86,.628,0,0,,54,86,.628,.628,16,24,.667,27,61,88,22,6,11,16,29,124
Danny Green,2015,SG,27,SAS,7,7,204,21,61,.344,12,40,.300,9,21,.429,.443,4,6,.667,7,15,22,15,7,7,5,12,58
Draymond Green,2015,PF,24,GSW,21,21,784,100,240,.417,24,91,.264,76,149,.510,.467,64,87,.736,46,166,212,109,38,25,58,89,288
JaMychal Green,2015,PF,24,MEM,5,0,8,0,2,.000,0,1,.000,0,1,.000,.000,2,2,1.000,0,3,3,0,1,1,0,1,2
Jeff Green,2015,SF,28,MEM,11,2,298,36,108,.333,4,18,.222,32,90,.356,.352,22,26,.846,9,43,52,19,5,5,16,18,98
Blake Griffin,2015,PF,25,LAC,14,14,557,140,274,.511,1,7,.143,139,267,.521,.513,76,106,.717,38,140,178,86,14,14,45,43,357
Jorge GutiÃ©rrez,2015,PG,26,MIL,1,0,12,1,2,.500,0,0,,1,2,.500,.500,0,0,,0,1,1,1,0,0,0,1,2
Tyler Hansbrough,2015,PF,29,TOR,4,2,48,1,5,.200,0,0,,1,5,.200,.200,3,4,.750,1,5,6,3,2,1,2,8,5
James Harden,2015,SG,25,HOU,17,17,636,129,294,.439,41,107,.383,88,187,.471,.509,163,178,.916,12,85,97,128,28,7,77,49,462
Devin Harris,2015,PG,31,DAL,4,0,74,8,23,.348,0,11,.000,8,12,.667,.348,8,9,.889,1,7,8,4,2,0,4,10,24
Joe Harris,2015,SG,23,CLE,6,0,16,2,6,.333,1,3,.333,1,3,.333,.417,3,4,.750,0,1,1,1,0,0,1,1,8
Spencer Hawes,2015,PF,26,LAC,8,0,57,9,17,.529,3,6,.500,6,11,.545,.618,2,2,1.000,3,10,13,5,2,3,1,12,23
Brendan Haywood,2015,C,35,CLE,1,0,2,0,1,.000,0,0,,0,1,.000,.000,0,0,,0,0,0,0,0,0,0,0,0
John Henson,2015,C,24,MIL,6,0,153,24,41,.585,0,1,.000,24,40,.600,.585,5,14,.357,21,27,48,4,5,10,11,14,53
NenÃª,2015,PF,32,WAS,10,10,257,34,76,.447,0,0,,34,76,.447,.447,11,23,.478,25,41,66,15,9,3,14,32,79
Kirk Hinrich,2015,SG,34,CHI,10,0,126,9,19,.474,6,10,.600,3,9,.333,.632,2,3,.667,0,5,5,11,3,1,1,14,26
Jrue Holiday,2015,PG,24,NOP,3,0,55,7,19,.368,1,4,.250,6,15,.400,.395,4,4,1.000,2,1,3,13,2,1,5,3,19
Justin Holiday,2015,SG,25,GSW,5,0,11,1,2,.500,1,1,1.000,0,1,.000,.750,0,0,,0,1,1,1,0,0,2,1,3
Al Horford,2015,C,28,ATL,16,16,522,107,211,.507,2,9,.222,105,202,.520,.512,15,20,.750,40,98,138,59,13,23,25,34,231
Dwight Howard,2015,C,29,HOU,17,17,574,105,182,.577,0,0,,105,182,.577,.577,68,165,.412,62,176,238,20,23,39,37,60,278
Lester Hudson,2015,SG,30,LAC,7,0,38,6,14,.429,2,7,.286,4,7,.571,.500,0,0,,0,1,1,7,2,1,3,8,14
Kris Humphries,2015,PF,29,WAS,1,0,5,1,1,1.000,0,0,,1,1,1.000,1.000,0,0,,0,3,3,0,0,0,0,1,2
Andre Iguodala,2015,SF,31,GSW,21,3,635,81,171,.474,29,82,.354,52,89,.584,.558,27,65,.415,16,78,94,75,25,7,14,42,218
Ersan Ä°lyasova,2015,PF,27,MIL,6,6,142,20,61,.328,5,23,.217,15,38,.395,.369,7,10,.700,6,17,23,3,5,3,5,10,52
Kyrie Irving,2015,PG,22,CLE,13,13,464,81,185,.438,27,60,.450,54,125,.432,.511,58,69,.841,10,37,47,50,17,11,20,29,247
Jarrett Jack,2015,PG,31,BRK,6,0,153,28,54,.519,5,15,.333,23,39,.590,.565,13,13,1.000,2,23,25,27,7,1,20,14,74
Bernard James,2015,C,29,DAL,1,0,2,0,0,,0,0,,0,0,,,0,0,,0,0,0,0,0,0,0,0,0
LeBron James,2015,SF,30,CLE,20,20,844,227,544,.417,25,110,.227,202,434,.465,.440,122,167,.731,37,189,226,169,33,21,82,58,601
Richard Jefferson,2015,SF,34,DAL,4,2,51,5,14,.357,3,8,.375,2,6,.333,.464,2,2,1.000,0,2,2,1,2,0,3,9,15
John Jenkins,2015,SG,23,ATL,4,0,21,4,6,.667,2,4,.500,2,2,1.000,.833,0,0,,1,2,3,0,0,0,0,2,10
Jonas Jerebko,2015,PF,27,BOS,4,0,68,5,15,.333,0,4,.000,5,11,.455,.333,1,2,.500,4,10,14,1,2,1,3,9,11
Amir Johnson,2015,PF,27,TOR,4,2,112,20,29,.690,0,1,.000,20,28,.714,.690,6,12,.500,7,21,28,4,1,3,7,16,46
James Johnson,2015,PF,27,TOR,2,0,12,2,6,.333,0,0,,2,6,.333,.333,0,6,.000,0,2,2,1,0,0,0,0,4
Joe Johnson,2015,SG,33,BRK,6,6,249,34,94,.362,12,41,.293,22,53,.415,.426,19,24,.792,5,41,46,29,7,0,5,16,99
Nick Johnson,2015,SG,22,HOU,9,0,49,4,17,.235,1,7,.143,3,10,.300,.265,3,3,1.000,1,3,4,4,0,1,4,7,12
Dahntay Jones,2015,SF,34,LAC,11,0,18,2,2,1.000,0,0,,2,2,1.000,1.000,0,0,,0,1,1,0,2,0,0,7,4
James Jones,2015,SF,34,CLE,20,0,311,26,75,.347,22,64,.344,4,11,.364,.493,13,14,.929,1,28,29,9,8,3,5,42,87
Terrence Jones,2015,PF,23,HOU,17,9,401,67,159,.421,3,19,.158,64,140,.457,.431,36,54,.667,29,52,81,17,8,12,16,31,173
DeAndre Jordan,2015,C,26,LAC,14,14,482,58,81,.716,0,0,,58,81,.716,.716,67,157,.427,49,138,187,16,16,33,17,42,183
Jerome Jordan,2015,C,28,BRK,1,0,5,0,2,.000,0,0,,0,2,.000,.000,0,0,,1,1,2,0,0,0,1,0,0
Cory Joseph,2015,PG,23,SAS,4,0,22,5,6,.833,0,0,,5,6,.833,.833,1,2,.500,0,1,1,0,0,1,1,2,11
Chris Kaman,2015,C,32,POR,3,0,37,4,8,.500,0,0,,4,8,.500,.500,1,1,1.000,5,9,14,3,0,0,3,5,9
Kyle Korver,2015,SG,33,ATL,14,14,526,52,133,.391,39,110,.355,13,23,.565,.538,13,16,.813,1,69,70,33,20,15,21,27,156
Kosta Koufos,2015,C,25,MEM,11,0,127,17,31,.548,0,0,,17,31,.548,.548,3,5,.600,19,20,39,4,4,6,1,14,37
Courtney Lee,2015,SG,29,MEM,11,11,367,55,100,.550,14,30,.467,41,70,.586,.620,22,23,.957,3,25,28,24,12,0,13,24,146
David Lee,2015,PF,31,GSW,13,0,107,16,40,.400,0,0,,16,40,.400,.400,8,15,.533,11,23,34,8,3,2,2,17,40
Kawhi Leonard,2015,SF,23,SAS,7,7,250,52,109,.477,11,26,.423,41,83,.494,.528,27,35,.771,13,39,52,18,8,4,15,18,142
Meyers Leonard,2015,C,22,POR,5,0,106,14,21,.667,10,13,.769,4,8,.500,.905,1,2,.500,6,27,33,5,2,2,3,17,39
Jon Leuer,2015,PF,25,MEM,4,0,9,2,4,.500,0,0,,2,4,.500,.500,0,0,,2,3,5,0,0,0,0,1,4
Damian Lillard,2015,PG,24,POR,5,5,201,39,96,.406,5,31,.161,34,65,.523,.432,25,32,.781,2,18,20,23,2,3,12,15,108
Shaun Livingston,2015,PG,29,GSW,21,0,375,42,79,.532,0,1,.000,42,78,.538,.532,21,25,.840,13,38,51,38,8,5,21,32,105
Brook Lopez,2015,C,26,BRK,6,6,234,43,87,.494,0,0,,43,87,.494,.494,33,40,.825,20,34,54,5,4,13,6,18,119
Robin Lopez,2015,C,26,POR,5,5,117,9,15,.600,0,0,,9,15,.600,.600,8,8,1.000,9,13,22,3,1,5,5,15,26
Kevin Love,2015,PF,26,CLE,4,4,107,17,41,.415,9,21,.429,8,20,.400,.524,14,19,.737,6,22,28,10,1,2,6,12,57
Kyle Lowry,2015,PG,28,TOR,4,4,131,18,57,.316,5,23,.217,13,34,.382,.360,8,11,.727,7,15,22,19,5,0,12,18,49
Shelvin Mack,2015,PG,24,ATL,10,0,99,15,39,.385,6,21,.286,9,18,.500,.462,3,6,.500,2,9,11,10,8,0,2,7,39
Shawn Marion,2015,SF,36,CLE,6,0,25,1,6,.167,0,0,,1,6,.167,.167,0,0,,2,4,6,1,2,0,0,1,2
O.J. Mayo,2015,SG,27,MIL,6,0,156,18,54,.333,6,19,.316,12,35,.343,.389,12,12,1.000,1,19,20,18,7,1,9,14,54
James Michael McAdoo,2015,PF,22,GSW,5,0,10,2,3,.667,0,0,,2,3,.667,.667,0,0,,1,3,4,0,0,1,1,0,4
CJ McCollum,2015,SG,23,POR,5,1,166,32,67,.478,11,23,.478,21,44,.477,.560,10,13,.769,1,19,20,2,6,1,6,13,85
Doug McDermott,2015,SF,23,CHI,3,0,10,1,3,.333,1,2,.500,0,1,.000,.500,2,2,1.000,1,1,2,1,0,0,1,0,5
Khris Middleton,2015,SF,23,MIL,6,6,232,35,92,.380,11,34,.324,24,58,.414,.440,14,15,.933,7,15,22,12,14,3,10,14,95
Mike Miller,2015,SF,34,CLE,9,1,65,3,5,.600,3,5,.600,0,0,,.900,0,0,,0,10,10,0,1,1,1,6,9
Patty Mills,2015,PG,26,SAS,7,0,112,21,42,.500,16,28,.571,5,14,.357,.690,13,13,1.000,4,15,19,8,2,0,5,15,71
Paul Millsap,2015,PF,29,ATL,16,15,566,85,209,.407,15,49,.306,70,160,.438,.443,58,78,.744,36,103,139,55,25,14,34,52,243
Nikola MirotiÄ,2015,PF,23,CHI,11,0,164,20,66,.303,7,30,.233,13,36,.361,.356,16,20,.800,7,23,30,9,6,6,8,22,63
Nazr Mohammed,2015,C,37,CHI,3,0,14,2,7,.286,0,1,.000,2,6,.333,.286,0,0,,3,2,5,0,0,1,0,0,4
E'Twaun Moore,2015,SG,25,CHI,3,0,9,2,6,.333,1,1,1.000,1,5,.200,.417,0,0,,0,3,3,0,2,0,0,1,5
Darius Morris,2015,PG,24,BRK,1,0,5,0,1,.000,0,0,,0,1,.000,.000,0,0,,0,0,0,0,0,0,0,0,0
Timofey Mozgov,2015,C,28,CLE,20,20,529,74,148,.500,0,0,,74,148,.500,.500,64,81,.790,57,89,146,13,8,36,37,57,212
Mike Muscala,2015,PF,23,ATL,10,0,102,20,33,.606,2,8,.250,18,25,.720,.636,0,0,,8,10,18,1,1,3,4,13,42
Joakim Noah,2015,C,29,CHI,12,12,395,31,76,.408,0,0,,31,76,.408,.408,7,20,.350,45,87,132,38,10,14,20,37,69
Dirk Nowitzki,2015,PF,36,DAL,5,5,181,38,84,.452,4,17,.235,34,67,.507,.476,26,28,.929,4,48,52,12,2,2,10,16,106
Johnny O'Bryant,2015,PF,21,MIL,1,0,12,3,8,.375,0,0,,3,8,.375,.375,0,0,,1,2,3,0,0,0,0,1,6
Kelly Olynyk,2015,C,23,BOS,4,0,53,7,13,.538,3,6,.500,4,7,.571,.654,1,2,.500,2,3,5,2,2,2,4,12,18
Zaza Pachulia,2015,C,30,MIL,6,6,129,16,40,.400,0,0,,16,40,.400,.400,8,13,.615,11,29,40,9,10,3,5,15,40
Kostas Papanikolaou,2015,SF,24,HOU,8,0,21,1,4,.250,0,3,.000,1,1,1.000,.250,1,2,.500,0,2,2,0,0,0,5,4,3
Tony Parker,2015,PG,32,SAS,7,7,210,33,91,.363,0,9,.000,33,82,.402,.363,10,17,.588,4,19,23,25,2,0,11,14,76
Chandler Parsons,2015,SF,26,DAL,1,1,37,5,15,.333,0,4,.000,5,11,.455,.333,0,0,,0,6,6,2,0,0,1,1,10
Patrick Patterson,2015,PF,25,TOR,4,0,106,15,27,.556,7,15,.467,8,12,.667,.685,4,4,1.000,4,10,14,5,3,0,3,5,41
Chris Paul,2015,PG,29,LAC,12,12,445,95,189,.503,27,65,.415,68,124,.548,.574,48,51,.941,7,46,53,105,22,3,26,37,265
Kendrick Perkins,2015,C,30,CLE,8,0,33,2,8,.250,0,0,,2,8,.250,.250,6,10,.600,2,7,9,0,0,3,4,6,10
Paul Pierce*,2015,SF,37,WAS,10,10,298,48,99,.485,33,63,.524,15,36,.417,.652,17,20,.850,0,42,42,9,6,7,10,33,146
Mason Plumlee,2015,C,24,BRK,6,0,49,4,6,.667,0,0,,4,6,.667,.667,4,11,.364,2,6,8,2,4,2,3,10,12
Miles Plumlee,2015,C,26,MIL,1,0,16,1,8,.125,0,0,,1,8,.125,.125,1,2,.500,3,3,6,1,0,1,1,1,3
Quincy Pondexter,2015,SF,26,NOP,4,4,124,10,28,.357,3,10,.300,7,18,.389,.411,6,7,.857,3,17,20,12,7,0,1,13,29
Otto Porter Jr.,2015,SF,21,WAS,10,0,331,39,88,.443,12,32,.375,27,56,.482,.511,10,21,.476,24,56,80,18,12,2,6,16,100
Dwight Powell,2015,PF,23,DAL,2,0,3,0,1,.000,0,0,,0,1,.000,.000,0,0,,0,1,1,1,0,0,0,1,0
Phil Pressey,2015,PG,23,BOS,2,0,5,0,3,.000,0,1,.000,0,2,.000,.000,0,0,,1,0,1,0,0,1,0,1,0
Pablo Prigioni,2015,PG,37,HOU,17,0,293,19,57,.333,12,41,.293,7,16,.438,.439,3,4,.750,6,13,19,39,15,0,12,40,53
Zach Randolph,2015,PF,33,MEM,11,11,382,71,168,.423,1,5,.200,70,163,.429,.426,29,33,.879,32,61,93,23,6,0,23,37,172
J.J. Redick,2015,SG,30,LAC,14,14,540,70,161,.435,35,88,.398,35,73,.479,.543,33,35,.943,0,30,30,24,10,5,26,36,208
Austin Rivers,2015,PG,22,LAC,14,2,250,46,105,.438,13,35,.371,33,70,.471,.500,12,19,.632,6,18,24,16,10,4,12,28,117
Rajon Rondo,2015,PG,28,DAL,2,2,37,9,20,.450,1,2,.500,8,18,.444,.475,0,0,,1,1,2,6,0,0,2,6,19
Derrick Rose,2015,PG,26,CHI,12,12,454,93,235,.396,23,66,.348,70,169,.414,.445,35,39,.897,13,45,58,78,14,6,38,22,244
Terrence Ross,2015,SF,23,TOR,4,4,107,11,29,.379,6,18,.333,5,11,.455,.483,0,0,,0,6,6,4,3,4,2,10,28
Brandon Rush,2015,SG,29,GSW,3,0,7,1,6,.167,1,2,.500,0,4,.000,.250,0,0,,1,2,3,0,0,0,0,2,3
Dennis SchrÃ¶der,2015,PG,21,ATL,16,0,290,56,145,.386,8,34,.235,48,111,.432,.414,24,28,.857,5,24,29,62,9,0,27,28,144
Mike Scott,2015,PF,26,ATL,11,0,172,21,55,.382,4,26,.154,17,29,.586,.418,4,4,1.000,16,30,46,5,5,0,7,16,50
Kevin SÃ©raphin,2015,C,25,WAS,6,0,72,15,31,.484,0,0,,15,31,.484,.484,3,6,.500,3,16,19,2,2,1,4,10,33
Ramon Sessions,2015,PG,28,WAS,10,3,218,26,70,.371,10,25,.400,16,45,.356,.443,13,19,.684,2,22,24,23,4,1,10,14,75
Iman Shumpert,2015,SG,24,CLE,20,16,695,59,164,.360,33,93,.355,26,71,.366,.460,30,40,.750,23,75,98,23,25,16,13,50,181
Marcus Smart,2015,PG,20,BOS,4,3,90,14,29,.483,3,13,.231,11,16,.688,.534,8,15,.533,5,6,11,5,1,1,4,12,39
Greg Smith,2015,PF,24,DAL,1,0,1,0,0,,0,0,,0,0,,,0,0,,0,0,0,0,0,0,0,0,0
J.R. Smith,2015,SG,29,CLE,18,4,560,83,206,.403,51,142,.359,32,64,.500,.527,14,20,.700,9,76,85,22,17,10,15,54,231
Josh Smith,2015,PF,29,HOU,17,8,396,85,194,.438,27,71,.380,58,123,.472,.508,32,74,.432,26,70,96,46,9,17,38,41,229
Russ Smith,2015,PG,23,MEM,2,0,3,0,0,,0,0,,0,0,,,0,0,,0,0,0,2,0,0,0,0,0
Tony Snell,2015,SF,23,CHI,11,0,140,15,44,.341,9,27,.333,6,17,.353,.443,4,4,1.000,1,16,17,6,0,3,5,13,43
Marreese Speights,2015,C,27,GSW,10,0,67,14,42,.333,0,0,,14,42,.333,.333,9,15,.600,8,13,21,4,4,3,4,14,37
Tiago Splitter,2015,C,30,SAS,7,7,123,9,24,.375,0,0,,9,24,.375,.375,6,19,.316,13,18,31,9,4,1,7,17,24
Greg Stiemsma,2015,C,29,TOR,1,0,2,2,2,1.000,0,0,,2,2,1.000,1.000,1,2,.500,0,0,0,0,0,0,0,0,5
Amar'e Stoudemire,2015,PF,32,DAL,5,0,75,15,35,.429,0,0,,15,35,.429,.429,9,13,.692,7,9,16,3,1,3,7,16,39
Jared Sullinger,2015,PF,22,BOS,4,0,80,21,38,.553,3,9,.333,18,29,.621,.592,4,7,.571,9,19,28,1,0,3,5,12,49
Jeff Teague,2015,PG,26,ATL,16,16,529,98,239,.410,21,65,.323,77,174,.443,.454,52,60,.867,10,41,51,107,24,7,43,34,269
Mirza TeletoviÄ,2015,PF,29,BRK,3,0,16,0,5,.000,0,4,.000,0,1,.000,.000,0,0,,0,4,4,0,1,0,1,1,0
Garrett Temple,2015,SG,28,WAS,4,0,26,1,6,.167,0,3,.000,1,3,.333,.167,5,8,.625,1,2,3,1,2,0,3,4,7
Jason Terry,2015,SG,37,HOU,17,17,487,57,134,.425,29,82,.354,28,52,.538,.534,13,16,.813,6,32,38,48,15,2,20,46,156
Isaiah Thomas,2015,PG,25,BOS,4,0,119,18,54,.333,3,18,.167,15,36,.417,.361,31,32,.969,1,11,12,28,3,0,14,10,70
Klay Thompson,2015,SG,24,GSW,21,21,761,149,334,.446,57,146,.390,92,188,.489,.531,36,45,.800,9,72,81,54,16,19,41,64,391
Tristan Thompson,2015,PF,23,CLE,20,15,727,72,129,.558,0,0,,72,129,.558,.558,48,82,.585,88,128,216,9,5,24,15,50,192
Hedo TÃ¼rkoÄlu,2015,SF,35,LAC,11,0,55,4,17,.235,2,13,.154,2,4,.500,.294,0,0,,1,6,7,4,4,1,2,10,10
Evan Turner,2015,SG,26,BOS,4,4,118,16,44,.364,2,4,.500,14,40,.350,.386,8,9,.889,2,27,29,19,3,0,9,11,42
Ekpe Udoh,2015,PF,27,LAC,4,0,12,1,3,.333,0,0,,1,3,.333,.333,0,0,,0,3,3,0,0,0,0,3,2
Beno Udrih,2015,PG,32,MEM,10,0,175,31,73,.425,4,16,.250,27,57,.474,.452,10,12,.833,4,16,20,21,5,0,4,16,76
Jonas ValanÄiÅ«nas,2015,C,22,TOR,4,4,106,19,38,.500,0,0,,19,38,.500,.500,7,8,.875,9,28,37,2,2,1,4,7,45
Greivis VÃ¡squez,2015,PG,28,TOR,4,0,101,11,29,.379,5,14,.357,6,15,.400,.466,3,3,1.000,0,7,7,12,2,0,4,15,30
Charlie Villanueva,2015,PF,30,DAL,5,0,43,11,25,.440,8,19,.421,3,6,.500,.600,0,0,,4,9,13,3,1,1,0,10,30
John Wall,2015,PG,24,WAS,7,7,273,43,110,.391,3,17,.176,40,93,.430,.405,33,39,.846,5,28,33,83,10,10,27,13,122
Gerald Wallace,2015,SF,32,BOS,1,0,4,0,1,.000,0,0,,0,1,.000,.000,0,0,,0,1,1,0,0,0,0,0,0
Martell Webster,2015,SF,28,WAS,1,0,4,1,2,.500,0,1,.000,1,1,1.000,.500,0,0,,0,0,0,0,0,0,0,0,2
Deron Williams,2015,PG,30,BRK,6,6,192,27,69,.391,11,26,.423,16,43,.372,.471,6,7,.857,3,34,37,33,8,0,16,18,71
Lou Williams,2015,SG,28,TOR,4,0,102,16,51,.314,4,21,.190,12,30,.400,.353,15,18,.833,2,5,7,5,6,0,3,9,51
Thaddeus Young,2015,PF,26,BRK,6,6,190,29,66,.439,0,4,.000,29,62,.468,.439,5,12,.417,17,26,43,16,5,1,14,15,63
Tyler Zeller,2015,C,25,BOS,4,4,90,15,29,.517,0,0,,15,29,.517,.517,4,5,.800,2,16,18,2,2,1,4,5,34
Steven Adams,2016,C,22,OKC,18,18,553,68,111,.613,0,1,.000,68,110,.618,.613,46,73,.630,62,109,171,13,9,14,17,55,182
Cole Aldrich,2016,C,27,LAC,6,0,77,10,15,.667,0,0,,10,15,.667,.667,3,6,.500,8,22,30,3,6,3,2,11,23
LaMarcus Aldridge,2016,PF,30,SAS,10,10,337,88,169,.521,2,2,1.000,86,167,.515,.527,41,46,.891,22,61,83,10,4,14,11,18,219
Lavoy Allen,2016,PF,26,IND,6,3,51,3,10,.300,0,0,,3,10,.300,.300,0,0,,4,10,14,2,1,1,1,2,6
Tony Allen,2016,SG,34,MEM,4,2,94,10,33,.303,1,7,.143,9,26,.346,.318,9,13,.692,6,5,11,3,5,2,6,11,30
Al-Farouq Aminu,2016,SF,25,POR,11,11,372,56,128,.438,28,70,.400,28,58,.483,.547,21,29,.724,23,72,95,20,8,10,21,31,161
Chris Andersen,2016,C,37,MEM,4,2,79,5,12,.417,0,0,,5,12,.417,.417,5,8,.625,13,18,31,3,2,3,5,4,15
Justin Anderson,2016,SF,22,DAL,5,1,95,17,37,.459,4,13,.308,13,24,.542,.514,9,14,.643,9,11,20,7,4,3,5,12,47
Kyle Anderson,2016,SF,22,SAS,10,0,129,8,25,.320,1,3,.333,7,22,.318,.340,6,7,.857,2,22,24,7,6,3,4,11,23
Trevor Ariza,2016,SF,30,HOU,5,5,181,13,51,.255,4,28,.143,9,23,.391,.294,3,4,.750,7,14,21,4,13,1,12,16,33
Jeff Ayres,2016,C,28,LAC,2,0,2,1,1,1.000,0,0,,1,1,1.000,1.000,1,1,1.000,0,0,0,0,0,0,0,0,3
Leandro Barbosa,2016,SG,33,GSW,23,0,254,51,88,.580,11,28,.393,40,60,.667,.642,16,21,.762,11,16,27,15,11,1,11,24,129
J.J. Barea,2016,PG,31,DAL,4,2,100,11,34,.324,1,8,.125,10,26,.385,.338,2,2,1.000,0,6,6,20,0,0,11,8,25
Harrison Barnes,2016,SF,23,GSW,24,23,743,82,213,.385,26,76,.342,56,137,.409,.446,26,34,.765,27,85,112,30,17,4,18,46,216
Matt Barnes,2016,SF,35,MEM,4,4,139,16,46,.348,3,18,.167,13,28,.464,.380,8,10,.800,5,24,29,11,4,1,13,13,43
Nicolas Batum,2016,SF,27,CHO,5,2,144,17,45,.378,6,22,.273,11,23,.478,.444,17,20,.850,2,16,18,10,2,0,8,6,57
Aron Baynes,2016,C,29,DET,4,0,44,4,9,.444,0,0,,4,9,.444,.444,2,3,.667,3,5,8,2,0,0,3,4,10
Kent Bazemore,2016,SF,26,ATL,10,10,325,44,121,.364,16,61,.262,28,60,.467,.430,15,22,.682,8,58,66,19,14,6,10,14,119
Michael Beasley,2016,PF,27,HOU,5,0,80,22,46,.478,2,6,.333,20,40,.500,.500,6,7,.857,4,17,21,3,1,0,7,8,52
Patrick Beverley,2016,PG,27,HOU,5,5,129,10,37,.270,3,14,.214,7,23,.304,.311,6,6,1.000,4,18,22,11,2,2,4,17,29
Bismack Biyombo,2016,C,23,TOR,20,10,506,40,69,.580,0,0,,40,69,.580,.580,43,72,.597,53,134,187,8,8,27,21,48,123
Steve Blake,2016,PG,35,DET,4,0,43,1,5,.200,1,2,.500,0,3,.000,.300,1,2,.500,0,4,4,10,0,0,5,7,4
Andrew Bogut,2016,C,31,GSW,22,22,365,48,77,.623,0,2,.000,48,75,.640,.623,5,14,.357,47,78,125,30,14,35,19,72,101
Avery Bradley,2016,SG,25,BOS,1,1,33,7,16,.438,1,7,.143,6,9,.667,.469,3,3,1.000,2,1,3,1,1,1,1,2,18
Corey Brewer,2016,SF,29,HOU,5,1,77,7,27,.259,1,10,.100,6,17,.353,.278,7,8,.875,3,4,7,8,0,1,6,13,22
Reggie Bullock,2016,SF,24,DET,2,0,22,5,6,.833,2,3,.667,3,3,1.000,1.000,0,0,,0,2,2,3,1,0,0,2,12
Kentavious Caldwell-Pope,2016,SG,22,DET,4,4,161,22,50,.440,12,27,.444,10,23,.435,.560,5,7,.714,2,15,17,11,7,1,2,7,61
Clint Capela,2016,C,21,HOU,5,0,43,3,9,.333,0,0,,3,9,.333,.333,2,5,.400,8,12,20,2,3,2,3,5,8
DeMarre Carroll,2016,SF,29,TOR,20,19,596,62,159,.390,26,79,.329,36,80,.450,.472,27,36,.750,23,58,81,17,18,7,18,62,177
Vince Carter,2016,SG,39,MEM,4,4,91,15,33,.455,7,10,.700,8,23,.348,.561,8,8,1.000,5,10,15,5,2,1,3,9,45
Ian Clark,2016,SG,24,GSW,16,0,154,26,53,.491,6,18,.333,20,35,.571,.547,8,10,.800,2,15,17,16,8,0,9,18,66
Nick Collison,2016,PF,35,OKC,9,0,79,4,6,.667,0,0,,4,6,.667,.667,1,2,.500,3,8,11,5,8,0,1,17,9
Pat Connaughton,2016,SG,23,POR,6,0,8,3,5,.600,2,3,.667,1,2,.500,.800,0,0,,0,1,1,0,0,0,0,0,8
Allen Crabbe,2016,SG,23,POR,11,0,302,38,73,.521,15,35,.429,23,38,.605,.623,14,19,.737,5,27,32,15,7,1,6,23,105
Jamal Crawford,2016,SG,35,LAC,6,1,199,39,103,.379,4,21,.190,35,82,.427,.398,22,25,.880,2,11,13,13,10,0,9,9,104
Jae Crowder,2016,SF,25,BOS,6,6,197,20,72,.278,10,41,.244,10,31,.323,.347,7,11,.636,5,34,39,13,9,3,7,17,57
Stephen Curry,2016,PG,27,GSW,18,17,614,148,338,.438,80,198,.404,68,140,.486,.556,76,83,.916,14,85,99,93,26,5,75,39,452
Troy Daniels,2016,SG,24,CHO,4,0,18,1,8,.125,0,3,.000,1,5,.200,.125,0,0,,0,2,2,0,0,0,0,2,2
Ed Davis,2016,PF,26,POR,11,0,205,21,40,.525,0,2,.000,21,38,.553,.525,19,33,.576,26,49,75,14,2,7,10,33,61
Matthew Dellavedova,2016,PG,25,CLE,20,0,241,26,74,.351,8,31,.258,18,43,.419,.405,18,24,.750,4,11,15,56,1,1,14,31,78
Luol Deng,2016,PF,30,MIA,14,14,495,65,138,.471,24,57,.421,41,81,.506,.558,32,38,.842,19,64,83,22,13,9,23,24,186
DeMar DeRozan,2016,SG,26,TOR,20,20,746,157,398,.394,4,26,.154,153,372,.411,.399,100,123,.813,13,70,83,54,22,3,45,52,418
Boris Diaw,2016,PF,33,SAS,9,0,159,21,46,.457,2,6,.333,19,40,.475,.478,3,4,.750,2,17,19,21,2,4,6,9,47
Spencer Dinwiddie,2016,PG,22,DET,1,0,2,1,1,1.000,0,0,,1,1,1.000,1.000,0,0,,0,0,0,1,0,0,0,0,2
Goran DragiÄ,2016,PG,29,MIA,14,14,472,91,206,.442,16,46,.348,75,160,.469,.481,33,43,.767,11,58,69,54,6,3,31,46,231
Andre Drummond,2016,C,22,DET,4,4,131,28,54,.519,0,1,.000,28,53,.528,.519,11,34,.324,12,24,36,0,1,6,4,8,67
Tim Duncan*,2016,C,39,SAS,10,10,218,22,52,.423,0,0,,22,52,.423,.423,15,21,.714,10,38,48,14,2,13,10,18,59
Kevin Durant,2016,SF,27,OKC,18,18,726,175,407,.430,31,110,.282,144,297,.485,.468,130,146,.890,13,115,128,60,18,18,65,37,511
Monta Ellis,2016,SG,30,IND,7,7,225,33,76,.434,7,21,.333,26,55,.473,.480,8,10,.800,4,23,27,30,15,0,17,17,81
Festus Ezeli,2016,C,26,GSW,23,1,203,37,69,.536,0,0,,37,69,.536,.536,19,44,.432,23,38,61,8,1,7,14,34,93
Jordan Farmar,2016,PG,29,MEM,4,4,113,10,31,.323,4,12,.333,6,19,.316,.387,3,3,1.000,0,6,6,16,3,1,10,4,27
Raymond Felton,2016,PG,31,DAL,5,4,172,32,69,.464,4,14,.286,28,55,.509,.493,7,11,.636,2,21,23,23,6,0,12,14,75
Randy Foye,2016,SG,32,OKC,16,0,190,14,41,.341,8,26,.308,6,15,.400,.439,4,4,1.000,2,18,20,13,2,3,11,18,40
Enes Freedom,2016,C,23,OKC,18,0,323,65,118,.551,2,14,.143,63,104,.606,.559,38,45,.844,47,64,111,5,5,11,17,40,170
Channing Frye,2016,C,32,CLE,17,0,237,41,69,.594,26,46,.565,15,23,.652,.783,6,7,.857,5,36,41,5,6,9,5,37,114
Paul George,2016,SF,25,IND,7,7,275,56,123,.455,18,43,.419,38,80,.475,.528,61,64,.953,9,44,53,30,14,5,23,24,191
Manu GinÃ³bili*,2016,SG,38,SAS,10,0,192,20,47,.426,9,21,.429,11,26,.423,.521,18,23,.783,6,21,27,25,8,3,7,25,67
Andrew Goudelock,2016,PG,27,HOU,2,0,11,3,6,.500,0,1,.000,3,5,.600,.500,0,0,,0,2,2,0,0,0,3,0,6
Danny Green,2016,SG,28,SAS,10,10,267,30,64,.469,24,47,.511,6,17,.353,.656,2,3,.667,0,31,31,7,21,8,6,20,86
Draymond Green,2016,PF,25,GSW,23,23,879,119,276,.431,38,104,.365,81,172,.471,.500,79,107,.738,38,190,228,138,37,41,56,81,355
Gerald Green,2016,SG,30,MIA,12,0,110,16,49,.327,4,14,.286,12,35,.343,.367,4,5,.800,2,15,17,1,4,1,2,14,40
JaMychal Green,2016,PF,25,MEM,4,0,72,12,22,.545,0,1,.000,12,21,.571,.545,3,6,.500,5,10,15,3,3,5,4,12,27
Jeff Green,2016,SF,29,LAC,6,1,159,21,46,.457,4,10,.400,17,36,.472,.500,15,25,.600,3,16,19,4,6,2,3,12,61
Blake Griffin,2016,PF,26,LAC,4,4,127,20,53,.377,1,2,.500,19,51,.373,.387,19,25,.760,7,28,35,16,3,2,9,9,60
Jorge GutiÃ©rrez,2016,PG,27,CHO,3,0,12,0,3,.000,0,0,,0,3,.000,.000,0,0,,0,2,2,2,0,0,1,0,0
P.J. Hairston,2016,SF,23,MEM,2,0,22,2,6,.333,1,3,.333,1,3,.333,.417,0,2,.000,0,0,0,0,1,0,1,1,5
Tyler Hansbrough,2016,PF,30,CHO,2,0,6,0,0,,0,0,,0,0,,,0,0,,0,0,0,0,0,0,0,0,0
Tim Hardaway Jr.,2016,SG,23,ATL,9,0,87,7,26,.269,2,14,.143,5,12,.417,.308,4,6,.667,0,9,9,7,0,1,3,2,20
James Harden,2016,SG,26,HOU,5,5,193,41,100,.410,13,42,.310,28,58,.483,.475,38,45,.844,7,19,26,38,12,1,26,13,133
Maurice Harkless,2016,SF,22,POR,11,11,272,47,110,.427,15,44,.341,32,66,.485,.495,12,25,.480,22,34,56,7,10,3,11,38,121
Montrezl Harrell,2016,PF,22,HOU,2,0,12,1,3,.333,0,1,.000,1,2,.500,.333,1,2,.500,0,2,2,0,0,0,1,1,3
Devin Harris,2016,PG,32,DAL,5,0,121,15,30,.500,4,13,.308,11,17,.647,.567,5,10,.500,1,13,14,8,3,0,3,16,39
Tobias Harris,2016,PF,23,DET,4,4,156,21,46,.457,4,12,.333,17,34,.500,.500,12,13,.923,6,32,38,12,3,3,6,11,58
Aaron Harrison,2016,SG,21,CHO,2,0,7,0,0,,0,0,,0,0,,,0,0,,0,1,1,0,0,0,0,1,0
Udonis Haslem,2016,PF,35,MIA,9,0,85,8,15,.533,0,0,,8,15,.533,.533,5,7,.714,11,20,31,4,0,1,7,13,21
Spencer Hawes,2016,PF,27,CHO,5,0,53,6,13,.462,1,4,.250,5,9,.556,.500,5,6,.833,3,13,16,3,1,2,4,5,18
Gerald Henderson,2016,SG,28,POR,11,0,234,30,82,.366,7,19,.368,23,63,.365,.409,9,12,.750,6,29,35,17,6,3,5,21,76
George Hill,2016,PG,29,IND,7,7,235,32,57,.561,13,27,.481,19,30,.633,.675,18,22,.818,6,13,19,15,6,1,8,16,95
Jordan Hill,2016,C,28,IND,5,0,15,0,3,.000,0,0,,0,3,.000,.000,0,0,,2,4,6,2,0,0,0,1,0
Solomon Hill,2016,SF,24,IND,7,0,198,14,31,.452,11,19,.579,3,12,.250,.629,15,16,.938,5,23,28,8,2,0,3,20,54
Kirk Hinrich,2016,PG,35,ATL,6,0,27,2,7,.286,1,3,.333,1,4,.250,.357,0,0,,0,4,4,3,0,0,0,2,5
John Holland,2016,SF,27,BOS,1,0,1,0,1,.000,0,1,.000,0,0,,.000,0,0,,0,0,0,0,0,0,0,0,0
Al Horford,2016,C,29,ATL,10,10,327,54,116,.466,11,28,.393,43,88,.489,.513,15,16,.938,13,52,65,30,12,24,17,25,134
Dwight Howard,2016,C,30,HOU,5,5,180,26,48,.542,0,1,.000,26,47,.553,.542,14,38,.368,26,44,70,8,4,7,12,21,66
Josh Huestis,2016,PF,24,OKC,2,0,10,1,3,.333,1,2,.500,0,1,.000,.500,0,0,,1,2,3,0,0,0,0,1,3
Kris Humphries,2016,PF,30,ATL,4,0,56,13,28,.464,5,10,.500,8,18,.444,.554,6,6,1.000,8,16,24,4,2,5,2,9,37
R.J. Hunter,2016,SG,22,BOS,5,0,41,2,9,.222,1,5,.200,1,4,.250,.278,0,0,,1,5,6,3,0,1,1,3,5
Serge Ibaka,2016,PF,26,OKC,18,18,602,85,163,.521,31,69,.449,54,94,.574,.617,15,20,.750,23,90,113,10,14,24,9,51,216
Andre Iguodala,2016,SF,32,GSW,24,3,767,78,164,.476,25,65,.385,53,99,.535,.552,32,57,.561,35,70,105,90,29,10,23,37,213
Kyrie Irving,2016,PG,23,CLE,21,21,774,201,423,.475,51,116,.440,150,307,.489,.535,77,88,.875,15,47,62,98,36,13,48,46,530
Reggie Jackson,2016,PG,25,DET,4,4,147,25,55,.455,3,18,.167,22,37,.595,.482,4,4,1.000,2,11,13,37,6,2,10,10,57
LeBron James,2016,SF,31,CLE,21,21,822,219,417,.525,32,94,.340,187,323,.579,.564,82,124,.661,42,158,200,160,49,27,75,54,552
Al Jefferson,2016,C,31,CHO,7,5,168,42,83,.506,0,0,,42,83,.506,.506,9,13,.692,14,29,43,8,4,3,6,12,93
Richard Jefferson,2016,SF,35,CLE,21,2,381,44,84,.524,11,28,.393,33,56,.589,.589,15,20,.750,16,58,74,14,10,1,13,34,114
Jonas Jerebko,2016,PF,28,BOS,6,4,162,22,46,.478,7,22,.318,15,24,.625,.554,4,5,.800,7,34,41,10,2,4,5,15,55
Amir Johnson,2016,PF,28,BOS,6,6,134,22,33,.667,0,2,.000,22,31,.710,.667,7,9,.778,11,32,43,4,1,8,10,13,51
James Johnson,2016,PF,28,TOR,10,0,98,12,25,.480,4,9,.444,8,16,.500,.560,2,3,.667,3,12,15,6,3,0,7,13,30
Joe Johnson,2016,SF,34,MIA,14,14,492,68,158,.430,13,46,.283,55,112,.491,.472,21,24,.875,7,59,66,35,8,3,18,27,170
Stanley Johnson,2016,SF,19,DET,4,0,81,12,23,.522,6,10,.600,6,13,.462,.652,2,2,1.000,0,16,16,0,1,0,3,10,32
Tyler Johnson,2016,SG,23,MIA,5,0,61,5,11,.455,3,6,.500,2,5,.400,.591,8,11,.727,2,5,7,8,1,0,2,8,21
Wesley Johnson,2016,SF,28,LAC,6,0,77,5,14,.357,3,9,.333,2,5,.400,.464,3,3,1.000,5,13,18,2,1,4,2,6,16
Dahntay Jones,2016,SF,35,CLE,15,0,50,6,13,.462,1,3,.333,5,10,.500,.500,4,5,.800,0,7,7,2,1,1,1,3,17
James Jones,2016,SF,35,CLE,12,0,55,2,10,.200,1,7,.143,1,3,.333,.250,1,4,.250,1,3,4,3,0,0,1,3,6
DeAndre Jordan,2016,C,27,LAC,6,6,198,24,38,.632,0,0,,24,38,.632,.632,22,59,.373,30,68,98,11,7,16,7,17,70
Cory Joseph,2016,SG,24,TOR,20,0,452,69,148,.466,8,24,.333,61,124,.492,.493,24,32,.750,11,30,41,47,18,2,22,47,170
Chris Kaman,2016,C,33,POR,4,0,32,7,18,.389,0,0,,7,18,.389,.389,0,0,,2,6,8,1,2,0,6,10,14
Frank Kaminsky,2016,C,22,CHO,7,5,190,14,46,.304,5,17,.294,9,29,.310,.359,17,21,.810,3,27,30,8,6,5,2,15,50
Kyle Korver,2016,SG,34,ATL,10,8,316,35,75,.467,24,54,.444,11,21,.524,.627,9,9,1.000,3,45,48,10,10,4,8,23,103
Jeremy Lamb,2016,SG,23,CHO,3,0,12,5,9,.556,1,1,1.000,4,8,.500,.611,0,0,,1,3,4,1,0,0,0,0,11
Ty Lawson,2016,PG,28,IND,7,0,74,6,18,.333,0,3,.000,6,15,.400,.333,4,6,.667,1,6,7,10,3,0,6,8,16
Courtney Lee,2016,SG,30,CHO,7,7,257,21,51,.412,4,9,.444,17,42,.405,.451,14,15,.933,5,15,20,9,6,3,5,19,60
David Lee,2016,PF,32,DAL,2,0,33,6,8,.750,0,0,,6,8,.750,.750,0,0,,1,5,6,1,0,0,0,7,12
Kawhi Leonard,2016,SF,24,SAS,10,10,339,83,166,.500,17,39,.436,66,127,.520,.551,42,51,.824,14,49,63,28,26,14,16,21,225
Damian Lillard,2016,PG,25,POR,11,11,437,89,242,.368,42,107,.393,47,135,.348,.455,71,78,.910,12,35,47,69,14,3,33,23,291
Jeremy Lin,2016,SG,27,CHO,7,0,189,26,63,.413,3,14,.214,23,49,.469,.437,32,39,.821,3,13,16,18,5,0,11,21,87
Shaun Livingston,2016,PG,30,GSW,24,7,514,82,168,.488,0,1,.000,82,167,.491,.488,32,37,.865,13,63,76,80,12,5,29,48,196
Kevin Love,2016,PF,27,CLE,20,19,613,92,239,.385,46,111,.414,46,128,.359,.481,63,75,.840,34,141,175,42,9,8,27,34,293
Kyle Lowry,2016,PG,29,TOR,20,20,766,131,330,.397,42,138,.304,89,192,.464,.461,78,104,.750,18,76,94,119,32,3,63,73,382
Ian Mahinmi,2016,C,29,IND,7,7,172,21,42,.500,0,0,,21,42,.500,.500,15,25,.600,12,24,36,8,5,6,14,25,57
Boban MarjanoviÄ,2016,C,27,SAS,7,0,42,8,12,.667,0,0,,8,12,.667,.667,8,9,.889,4,10,14,3,0,2,3,10,24
Jarell Martin,2016,PF,21,MEM,2,0,46,3,8,.375,0,0,,3,8,.375,.375,3,6,.500,4,3,7,1,3,0,3,4,9
Kevin Martin,2016,SG,32,SAS,5,0,49,8,20,.400,4,8,.500,4,12,.333,.500,2,3,.667,0,4,4,3,1,0,6,5,22
Wesley Matthews,2016,SF,29,DAL,5,5,173,20,60,.333,10,35,.286,10,25,.400,.417,15,19,.789,4,14,18,6,6,0,4,14,65
Luc Mbah a Moute,2016,PF,29,LAC,5,5,78,4,6,.667,0,0,,4,6,.667,.667,1,1,1.000,2,8,10,1,3,0,2,9,9
James Michael McAdoo,2016,PF,23,GSW,8,0,38,2,4,.500,0,0,,2,4,.500,.500,1,4,.250,0,8,8,2,3,2,1,6,5
CJ McCollum,2016,SG,24,POR,11,11,442,84,197,.426,20,58,.345,64,139,.460,.477,37,46,.804,7,33,40,36,10,5,20,30,225
K.J. McDaniels,2016,SF,22,HOU,4,0,34,4,13,.308,1,3,.333,3,10,.300,.346,0,0,,1,6,7,1,0,3,0,3,9
JaVale McGee,2016,C,28,DAL,2,0,14,1,2,.500,0,0,,1,2,.500,.500,2,6,.333,2,1,3,0,1,0,3,3,4
Jordan McRae,2016,PG,24,CLE,2,0,4,4,4,1.000,1,1,1.000,3,3,1.000,1.125,0,0,,0,2,2,0,0,0,0,0,9
Josh McRoberts,2016,PF,28,MIA,10,0,134,16,34,.471,0,7,.000,16,27,.593,.471,6,6,1.000,7,19,26,9,5,5,4,20,38
Jodie Meeks,2016,SG,28,DET,1,0,2,1,1,1.000,0,0,,1,1,1.000,1.000,0,0,,0,0,0,0,0,0,0,0,2
Salah Mejri,2016,C,29,DAL,4,1,76,7,10,.700,0,0,,7,10,.700,.700,5,12,.417,5,8,13,1,3,5,0,11,19
Jordan Mickey,2016,PF,21,BOS,2,0,10,2,4,.500,0,0,,2,4,.500,.500,0,0,,1,1,2,2,0,1,0,0,4
C.J. Miles,2016,SF,28,IND,7,0,92,10,38,.263,2,20,.100,8,18,.444,.289,2,3,.667,4,20,24,4,1,1,3,7,24
Andre Miller,2016,PG,39,SAS,5,0,35,3,7,.429,1,3,.333,2,4,.500,.500,2,2,1.000,2,3,5,7,0,0,0,4,9
Patty Mills,2016,PG,27,SAS,10,0,167,23,53,.434,13,36,.361,10,17,.588,.557,7,11,.636,0,14,14,20,7,0,8,3,66
Paul Millsap,2016,PF,30,ATL,10,10,365,59,137,.431,8,33,.242,51,104,.490,.460,41,55,.745,28,66,94,27,13,23,26,29,167
Nazr Mohammed,2016,C,38,OKC,5,0,10,1,2,.500,0,0,,1,2,.500,.500,0,0,,1,2,3,0,0,1,1,1,2
Luis Montero,2016,SG,22,POR,6,0,8,3,3,1.000,2,2,1.000,1,1,1.000,1.333,0,0,,0,0,0,0,0,0,0,1,8
Marcus Morris,2016,SF,26,DET,4,4,144,22,47,.468,7,18,.389,15,29,.517,.543,20,23,.870,2,11,13,10,2,0,5,17,71
Anthony Morrow,2016,SG,30,OKC,14,0,76,11,24,.458,5,14,.357,6,10,.600,.563,10,10,1.000,0,2,2,1,1,0,4,5,37
Donatas MotiejÅ«nas,2016,PF,25,HOU,5,4,98,16,37,.432,4,9,.444,12,28,.429,.486,8,17,.471,10,16,26,5,4,2,12,11,44
Timofey Mozgov,2016,C,29,CLE,13,0,76,6,15,.400,0,0,,6,15,.400,.400,3,4,.750,5,16,21,2,3,3,8,16,15
Xavier Munford,2016,SG,23,MEM,4,0,89,9,28,.321,1,8,.125,8,20,.400,.339,0,2,.000,1,8,9,10,6,3,5,8,19
Mike Muscala,2016,C,24,ATL,9,0,67,10,20,.500,2,6,.333,8,14,.571,.550,2,2,1.000,7,10,17,3,0,1,3,6,24
Lucas Nogueira,2016,C,23,TOR,5,0,29,3,4,.750,0,0,,3,4,.750,.750,0,0,,1,7,8,0,0,0,0,3,6
Dirk Nowitzki,2016,PF,37,DAL,5,5,170,41,83,.494,4,11,.364,37,72,.514,.518,16,17,.941,3,21,24,8,2,3,7,9,102
Kelly Olynyk,2016,C,24,BOS,4,0,32,1,9,.111,0,3,.000,1,6,.167,.111,0,0,,2,2,4,3,1,0,4,5,2
Zaza Pachulia,2016,C,31,DAL,5,4,112,9,24,.375,0,0,,9,24,.375,.375,15,17,.882,10,17,27,16,3,1,2,13,33
Tony Parker,2016,PG,33,SAS,10,10,264,44,98,.449,4,16,.250,40,82,.488,.469,12,14,.857,1,21,22,53,6,2,18,15,104
Lamar Patterson,2016,SG,24,ATL,4,0,20,2,7,.286,1,3,.333,1,4,.250,.357,1,1,1.000,0,5,5,3,1,0,4,1,6
Patrick Patterson,2016,PF,26,TOR,20,9,583,55,136,.404,21,70,.300,34,66,.515,.482,22,26,.846,29,48,77,24,7,9,18,31,153
Chris Paul,2016,PG,30,LAC,4,4,125,37,76,.487,6,20,.300,31,56,.554,.526,15,15,1.000,4,12,16,29,9,0,4,12,95
Cameron Payne,2016,PG,21,OKC,10,0,64,7,26,.269,2,10,.200,5,16,.313,.308,2,4,.500,0,4,4,8,2,2,8,7,18
Paul Pierce*,2016,SF,38,LAC,5,1,54,2,12,.167,1,5,.200,1,7,.143,.208,1,4,.250,0,6,6,1,2,0,2,6,6
Mason Plumlee,2016,C,25,POR,11,11,306,28,70,.400,0,0,,28,70,.400,.400,21,33,.636,37,93,130,53,7,11,25,42,77
Dwight Powell,2016,PF,24,DAL,4,0,64,9,19,.474,0,1,.000,9,18,.500,.474,6,11,.545,9,8,17,4,1,0,1,5,24
Norman Powell,2016,SG,22,TOR,18,3,206,27,70,.386,7,26,.269,20,44,.455,.436,7,8,.875,4,23,27,6,13,2,5,18,68
Pablo Prigioni,2016,PG,38,LAC,5,0,26,0,5,.000,0,2,.000,0,3,.000,.000,0,0,,2,1,3,7,0,0,3,8,0
Zach Randolph,2016,PF,34,MEM,4,4,120,23,62,.371,0,0,,23,62,.371,.371,6,7,.857,15,20,35,7,1,0,7,10,52
J.J. Redick,2016,SG,31,LAC,6,6,166,34,79,.430,11,31,.355,23,48,.479,.500,2,3,.667,1,11,12,5,1,1,5,11,81
Josh Richardson,2016,SG,22,MIA,14,0,387,33,89,.371,17,46,.370,16,43,.372,.466,10,14,.714,10,40,50,22,6,13,12,37,93
Austin Rivers,2016,SG,23,LAC,6,2,144,26,61,.426,4,17,.235,22,44,.500,.459,6,9,.667,4,12,16,16,3,0,7,12,62
Andre Roberson,2016,SG,24,OKC,18,18,471,40,86,.465,12,37,.324,28,49,.571,.535,8,20,.400,25,76,101,14,23,19,11,45,100
Brian Roberts,2016,PG,30,POR,10,0,36,2,9,.222,0,4,.000,2,5,.400,.222,4,6,.667,1,0,1,3,0,0,1,5,8
Glenn Robinson III,2016,SF,22,IND,4,0,10,3,4,.750,0,0,,3,4,.750,.750,1,1,1.000,0,0,0,0,0,1,0,0,7
Terrence Ross,2016,SF,24,TOR,20,0,335,46,119,.387,21,64,.328,25,55,.455,.475,13,20,.650,4,28,32,11,13,5,16,28,126
Terry Rozier,2016,PG,21,BOS,5,0,99,9,23,.391,4,11,.364,5,12,.417,.478,2,2,1.000,3,14,17,6,1,3,2,5,24
Brandon Rush,2016,SG,30,GSW,14,0,110,9,20,.450,4,12,.333,5,8,.625,.550,1,2,.500,0,23,23,3,2,2,2,9,23
Dennis SchrÃ¶der,2016,PG,22,ATL,10,0,191,47,104,.452,12,35,.343,35,69,.507,.510,11,13,.846,6,13,19,36,4,1,21,24,117
Luis Scola,2016,PF,35,TOR,11,9,140,8,31,.258,4,21,.190,4,10,.400,.323,8,11,.727,2,16,18,7,3,0,5,22,28
Mike Scott,2016,PF,27,ATL,10,0,161,25,40,.625,8,16,.500,17,24,.708,.725,7,8,.875,5,27,32,5,3,3,8,20,65
Thabo Sefolosha,2016,SF,31,ATL,10,2,203,22,46,.478,7,19,.368,15,27,.556,.554,8,15,.533,8,33,41,17,10,6,10,17,59
Iman Shumpert,2016,SG,25,CLE,21,0,367,25,60,.417,13,34,.382,12,26,.462,.525,7,11,.636,10,37,47,17,10,3,13,36,70
Jonathon Simmons,2016,SG,26,SAS,3,0,26,4,10,.400,2,3,.667,2,7,.286,.500,1,2,.500,3,1,4,2,2,0,1,4,11
Kyle Singler,2016,SF,27,OKC,6,0,51,3,9,.333,2,4,.500,1,5,.200,.444,0,2,.000,1,6,7,0,1,0,0,4,8
Marcus Smart,2016,PG,21,BOS,6,1,193,22,60,.367,11,32,.344,11,28,.393,.458,17,21,.810,8,19,27,18,10,5,15,17,72
J.R. Smith,2016,SG,30,CLE,21,21,730,82,188,.436,65,151,.430,17,37,.459,.609,13,21,.619,7,60,67,29,26,5,11,55,242
Josh Smith,2016,PF,30,HOU,4,0,38,6,13,.462,4,8,.500,2,5,.400,.615,0,2,.000,1,1,2,4,1,1,5,7,16
Marreese Speights,2016,C,28,GSW,24,0,201,46,118,.390,18,43,.419,28,75,.373,.466,24,31,.774,15,32,47,11,3,8,20,43,134
Lance Stephenson,2016,SF,25,MEM,4,0,95,23,44,.523,2,5,.400,21,39,.538,.545,4,5,.800,1,5,6,7,1,0,3,10,52
Amar'e Stoudemire,2016,C,33,MIA,9,2,82,11,19,.579,0,0,,11,19,.579,.579,8,8,1.000,3,10,13,0,5,3,9,14,30
Rodney Stuckey,2016,PG,29,IND,7,0,125,17,43,.395,5,10,.500,12,33,.364,.453,5,9,.556,1,14,15,14,4,1,6,9,44
Jared Sullinger,2016,PF,23,BOS,6,2,81,13,42,.310,2,4,.500,11,38,.289,.333,3,4,.750,10,17,27,7,1,0,6,16,31
Jeff Teague,2016,PG,27,ATL,10,10,279,46,121,.380,9,36,.250,37,85,.435,.417,44,52,.846,3,16,19,62,6,2,25,30,145
Jason Terry,2016,SG,38,HOU,5,0,124,13,38,.342,6,19,.316,7,19,.368,.421,3,3,1.000,1,10,11,6,2,1,3,13,35
Isaiah Thomas,2016,PG,26,BOS,6,6,220,47,119,.395,13,46,.283,34,73,.466,.450,38,47,.809,2,16,18,30,4,5,14,18,145
Jason Thompson,2016,C,29,TOR,10,0,55,4,9,.444,0,1,.000,4,8,.500,.444,0,3,.000,6,5,11,1,0,1,1,6,8
Klay Thompson,2016,SG,25,GSW,24,24,849,201,453,.444,98,231,.424,103,222,.464,.552,82,96,.854,15,73,88,54,26,9,47,53,582
Tristan Thompson,2016,PF,24,CLE,21,21,622,49,93,.527,0,0,,49,93,.527,.527,42,73,.575,86,102,188,15,8,18,17,55,140
Anthony Tolliver,2016,PF,30,DET,3,0,26,2,4,.500,0,2,.000,2,2,1.000,.500,0,0,,1,3,4,1,0,1,0,0,4
Evan Turner,2016,SG,27,BOS,6,4,214,31,85,.365,3,14,.214,28,71,.394,.382,14,18,.778,8,26,34,27,8,6,17,19,79
Myles Turner,2016,C,19,IND,7,4,197,33,71,.465,0,2,.000,33,69,.478,.465,6,9,.667,16,29,45,3,2,23,12,24,72
Jonas ValanÄiÅ«nas,2016,C,23,TOR,12,10,321,68,120,.567,0,0,,68,120,.567,.567,29,39,.744,48,81,129,11,10,14,18,32,165
Anderson VarejÃ£o,2016,C,33,GSW,17,0,93,5,14,.357,0,0,,5,14,.357,.357,10,19,.526,12,9,21,13,2,2,2,17,20
Charlie Villanueva,2016,PF,31,DAL,4,0,20,3,12,.250,1,5,.200,2,7,.286,.292,2,2,1.000,0,2,2,1,0,0,1,2,9
Noah Vonleh,2016,PF,20,POR,6,0,12,0,3,.000,0,0,,0,3,.000,.000,0,0,,1,3,4,2,2,0,0,1,0
Dwyane Wade,2016,SG,34,MIA,14,14,473,119,254,.469,12,23,.522,107,231,.463,.492,50,64,.781,12,67,79,60,11,13,38,22,300
Dion Waiters,2016,SG,24,OKC,18,0,491,55,132,.417,21,56,.375,34,76,.447,.496,20,30,.667,6,41,47,42,10,3,20,42,151
Kemba Walker,2016,PG,25,CHO,7,7,260,56,153,.366,14,43,.326,42,110,.382,.412,33,35,.943,3,18,21,28,9,4,12,10,159
Briante Weber,2016,PG,23,MIA,2,0,6,0,1,.000,0,0,,0,1,.000,.000,0,0,,0,0,0,1,1,0,0,1,0
David West,2016,PF,35,SAS,10,0,176,25,55,.455,3,6,.500,22,49,.449,.482,5,9,.556,13,24,37,13,6,7,7,19,58
Russell Westbrook,2016,PG,27,OKC,18,18,674,159,393,.405,34,105,.324,125,288,.434,.448,116,140,.829,41,83,124,198,46,2,78,43,468
Hassan Whiteside,2016,C,26,MIA,10,10,291,47,69,.681,0,0,,47,69,.681,.681,26,44,.591,26,83,109,3,8,28,13,34,120
C.J. Wilcox,2016,SG,25,LAC,2,0,7,0,1,.000,0,0,,0,1,.000,.000,0,0,,0,1,1,1,0,0,0,1,0
Deron Williams,2016,PG,31,DAL,3,3,49,6,18,.333,3,7,.429,3,11,.273,.417,0,0,,0,2,2,8,1,0,7,6,15
Marvin Williams,2016,PF,29,CHO,7,7,228,14,51,.275,6,17,.353,8,34,.235,.333,2,4,.500,7,41,48,6,6,3,2,11,36
Mo Williams,2016,PG,33,CLE,13,0,68,8,28,.286,3,13,.231,5,15,.333,.339,1,2,.500,0,6,6,3,4,0,10,8,20
Justise Winslow,2016,SF,19,MIA,13,2,330,32,74,.432,5,18,.278,27,56,.482,.466,21,30,.700,17,46,63,8,8,4,12,35,90
Delon Wright,2016,PG,23,TOR,9,0,41,3,10,.300,0,1,.000,3,9,.333,.300,8,13,.615,1,3,4,3,3,0,2,2,14
Dorell Wright,2016,SF,30,MIA,5,0,19,5,10,.500,2,5,.400,3,5,.600,.600,4,4,1.000,0,6,6,2,0,0,0,2,16
James Young,2016,SG,20,BOS,3,0,10,1,3,.333,0,1,.000,1,2,.500,.333,0,0,,0,0,0,0,0,0,1,1,2
Joe Young,2016,PG,23,IND,4,0,10,3,8,.375,1,4,.250,2,4,.500,.438,2,2,1.000,0,1,1,1,0,0,2,3,9
Cody Zeller,2016,C,23,CHO,7,2,137,21,38,.553,0,0,,21,38,.553,.553,17,21,.810,9,28,37,2,1,3,7,20,59
Tyler Zeller,2016,C,26,BOS,3,0,38,7,15,.467,0,0,,7,15,.467,.467,4,6,.667,4,11,15,2,0,2,2,1,18
Ãlex Abrines,2017,SG,23,OKC,5,0,80,8,23,.348,5,17,.294,3,6,.500,.457,3,4,.750,2,7,9,4,0,0,0,8,24
Steven Adams,2017,C,23,OKC,5,5,157,18,28,.643,0,0,,18,28,.643,.643,4,11,.364,17,17,34,7,6,9,4,14,40
LaMarcus Aldridge,2017,PF,31,SAS,16,16,537,110,240,.458,2,14,.143,108,226,.478,.463,42,55,.764,43,76,119,24,10,16,28,41,264
Lavoy Allen,2017,PF,27,IND,3,0,11,0,0,,0,0,,0,0,,,0,0,,0,2,2,0,0,0,1,0,0
Al-Farouq Aminu,2017,PF,26,POR,4,0,113,17,37,.459,7,17,.412,10,20,.500,.554,7,11,.636,5,21,26,4,3,4,9,9,48
Kyle Anderson,2017,SF,23,SAS,15,1,195,36,64,.563,3,10,.300,33,54,.611,.586,8,11,.727,12,34,46,25,10,2,7,8,83
Ryan Anderson,2017,PF,28,HOU,11,9,336,36,92,.391,17,60,.283,19,32,.594,.484,14,16,.875,15,42,57,7,4,2,9,24,103
Giannis Antetokounmpo,2017,SF,22,MIL,6,6,243,60,112,.536,4,10,.400,56,102,.549,.554,25,46,.543,10,47,57,24,13,10,20,21,149
Joel Anthony,2017,C,34,SAS,3,0,15,3,4,.750,0,0,,3,4,.750,.750,0,1,.000,2,2,4,0,0,2,1,2,6
Trevor Ariza,2017,SF,31,HOU,11,11,413,41,97,.423,23,61,.377,18,36,.500,.541,13,14,.929,8,48,56,23,14,2,9,25,118
Wade Baldwin,2017,PG,20,MEM,3,0,12,0,1,.000,0,0,,0,1,.000,.000,2,2,1.000,1,3,4,2,0,0,0,3,2
Matt Barnes,2017,SF,36,GSW,12,0,61,4,15,.267,1,8,.125,3,7,.429,.300,0,0,,0,9,9,7,2,0,3,9,9
Brandon Bass,2017,PF,31,LAC,1,0,4,1,3,.333,0,0,,1,3,.333,.333,0,0,,1,0,1,0,1,0,0,0,2
Kent Bazemore,2017,SF,27,ATL,6,0,150,21,53,.396,7,24,.292,14,29,.483,.462,10,14,.714,4,19,23,20,4,5,16,15,59
Bradley Beal,2017,SG,23,WAS,13,13,505,122,259,.471,29,101,.287,93,158,.589,.527,50,61,.820,15,29,44,35,21,8,27,38,323
Michael Beasley,2017,PF,28,MIL,4,0,48,7,20,.350,3,5,.600,4,15,.267,.425,0,4,.000,2,7,9,1,1,1,2,8,17
DÄvis BertÄns,2017,PF,24,SAS,13,0,112,12,27,.444,8,20,.400,4,7,.571,.593,4,6,.667,5,15,20,3,3,4,6,7,36
Patrick Beverley,2017,SG,28,HOU,11,11,325,45,109,.413,21,52,.404,24,57,.421,.509,11,14,.786,21,40,61,33,16,2,18,38,122
Bojan BogdanoviÄ,2017,SF,27,WAS,13,0,264,36,87,.414,16,45,.356,20,42,.476,.506,27,32,.844,10,46,56,9,6,1,8,17,115
Joel Bolomboy,2017,PF,23,UTA,2,0,9,2,3,.667,0,0,,2,3,.667,.667,0,0,,0,2,2,0,0,1,0,0,4
Avery Bradley,2017,SG,26,BOS,18,18,645,120,272,.441,40,114,.351,80,158,.506,.515,21,27,.778,18,53,71,41,23,3,31,40,301
Malcolm Brogdon,2017,SG,24,MIL,6,6,183,22,55,.400,10,21,.476,12,34,.353,.491,0,0,,3,23,26,21,3,2,12,12,54
Aaron Brooks,2017,PG,32,IND,1,0,7,2,3,.667,1,2,.500,1,1,1.000,.833,0,0,,0,1,1,1,0,0,1,0,5
Bobby Brown,2017,PG,32,HOU,5,0,22,10,20,.500,5,11,.455,5,9,.556,.625,0,0,,0,2,2,1,0,0,0,1,25
Jaylen Brown,2017,SF,20,BOS,17,0,215,34,71,.479,5,23,.217,29,48,.604,.514,12,18,.667,12,24,36,13,6,2,13,26,85
Trey Burke,2017,PG,24,WAS,3,0,20,0,4,.000,0,2,.000,0,2,.000,.000,0,0,,0,0,0,5,0,0,0,2,0
Jimmy Butler,2017,SF,27,CHI,6,6,239,46,108,.426,6,23,.261,40,85,.471,.454,38,47,.809,9,35,44,26,10,5,15,10,136
JosÃ© CalderÃ³n,2017,PG,35,ATL,6,0,75,11,23,.478,4,12,.333,7,11,.636,.565,0,0,,2,6,8,13,2,1,4,9,26
Isaiah Canaan,2017,SG,25,CHI,3,2,95,13,26,.500,5,14,.357,8,12,.667,.596,4,6,.667,0,4,4,4,3,0,5,6,35
Clint Capela,2017,C,22,HOU,11,11,286,46,82,.561,0,1,.000,46,81,.568,.561,24,39,.615,26,70,96,12,8,28,8,28,116
DeMarre Carroll,2017,SF,30,TOR,10,7,155,15,37,.405,7,22,.318,8,15,.533,.500,5,9,.556,4,23,27,5,8,5,5,13,42
Vince Carter,2017,SF,40,MEM,6,6,195,20,42,.476,8,20,.400,12,22,.545,.571,7,7,1.000,4,16,20,9,2,0,10,15,55
Michael Carter-Williams,2017,PG,25,CHI,5,0,53,6,15,.400,0,1,.000,6,14,.429,.400,2,4,.500,1,3,4,6,2,1,6,6,14
Semaj Christon,2017,PG,24,OKC,2,0,21,2,5,.400,1,3,.333,1,2,.500,.500,0,0,,0,3,3,5,1,0,0,1,5
Ian Clark,2017,SG,25,GSW,16,0,219,40,79,.506,13,36,.361,27,43,.628,.589,16,17,.941,4,22,26,11,6,0,11,17,109
Norris Cole,2017,PG,28,OKC,4,0,25,2,8,.250,1,4,.250,1,4,.250,.313,0,0,,0,1,1,1,0,1,2,4,5
Mike Conley,2017,PG,29,MEM,6,6,224,50,103,.485,17,38,.447,33,65,.508,.568,31,37,.838,1,19,20,42,10,3,12,11,148
Pat Connaughton,2017,SG,24,POR,3,0,24,2,9,.222,0,6,.000,2,3,.667,.222,3,3,1.000,1,6,7,4,0,0,0,0,7
Allen Crabbe,2017,SG,24,POR,4,0,92,9,24,.375,3,13,.231,6,11,.545,.438,1,3,.333,0,12,12,2,1,0,1,9,22
Jamal Crawford,2017,SG,36,LAC,7,0,196,35,83,.422,6,25,.240,29,58,.500,.458,12,12,1.000,2,7,9,13,4,1,9,12,88
Jae Crowder,2017,SF,26,BOS,18,18,596,87,200,.435,31,88,.352,56,112,.500,.513,40,48,.833,20,95,115,48,19,6,12,52,245
Stephen Curry,2017,PG,28,GSW,17,17,601,151,312,.484,72,172,.419,79,140,.564,.599,103,114,.904,22,84,106,114,34,4,58,37,477
Troy Daniels,2017,SG,25,MEM,6,0,68,3,9,.333,3,9,.333,0,0,,.500,0,0,,1,4,5,2,2,0,2,1,9
Deyonta Davis,2017,C,20,MEM,3,0,11,3,5,.600,0,0,,3,5,.600,.600,1,2,.500,2,3,5,0,0,0,0,2,7
Dewayne Dedmon,2017,C,27,SAS,12,3,97,14,23,.609,0,0,,14,23,.609,.609,17,32,.531,21,26,47,3,2,3,8,16,45
Sam Dekker,2017,PF,22,HOU,4,0,31,3,12,.250,3,6,.500,0,6,.000,.375,0,0,,5,5,10,1,1,1,0,2,9
Malcolm Delaney,2017,PG,27,ATL,1,0,3,3,3,1.000,1,1,1.000,2,2,1.000,1.167,1,2,.500,0,1,1,0,0,0,0,0,8
Matthew Dellavedova,2017,PG,26,MIL,6,0,159,16,41,.390,6,16,.375,10,25,.400,.463,8,10,.800,1,11,12,12,1,0,7,5,46
DeMar DeRozan,2017,SG,27,TOR,10,10,373,76,175,.434,1,15,.067,75,160,.469,.437,71,80,.888,4,45,49,34,14,0,25,26,224
Boris Diaw,2017,PF,34,UTA,11,9,203,24,48,.500,6,14,.429,18,34,.529,.563,9,10,.900,3,18,21,22,7,4,14,12,63
Mike Dunleavy,2017,SF,36,ATL,6,0,53,3,7,.429,2,5,.400,1,2,.500,.571,4,4,1.000,1,4,5,2,1,0,6,3,12
Kevin Durant,2017,PF,28,GSW,15,15,533,149,268,.556,38,86,.442,111,182,.610,.627,92,103,.893,16,103,119,64,12,20,38,39,428
Monta Ellis,2017,SG,31,IND,4,2,76,8,20,.400,2,8,.250,6,12,.500,.450,4,5,.800,1,7,8,5,2,1,4,5,22
James Ennis III,2017,SF,26,MEM,6,4,159,16,38,.421,6,19,.316,10,19,.526,.500,12,14,.857,8,17,25,7,5,2,7,20,50
Dante Exum,2017,PG,21,UTA,7,0,84,11,27,.407,4,12,.333,7,15,.467,.481,6,6,1.000,2,4,6,9,5,0,3,10,32
Derrick Favors,2017,PF,25,UTA,11,2,225,36,62,.581,0,0,,36,62,.581,.581,11,23,.478,15,45,60,10,8,6,4,25,83
Cristiano FelÃ­cio,2017,C,24,CHI,6,0,82,9,15,.600,0,0,,9,15,.600,.600,1,2,.500,7,19,26,2,3,2,7,16,19
Raymond Felton,2017,PG,32,LAC,7,0,127,15,32,.469,4,9,.444,11,23,.478,.531,5,5,1.000,2,8,10,10,6,0,3,10,39
Bryn Forbes,2017,SG,23,SAS,6,0,73,6,21,.286,2,9,.222,4,12,.333,.333,6,6,1.000,0,6,6,3,0,1,2,5,20
Enes Freedom,2017,C,24,OKC,5,0,45,10,26,.385,0,0,,10,26,.385,.385,4,4,1.000,3,6,9,1,0,4,2,8,24
Channing Frye,2017,C,33,CLE,12,0,154,31,60,.517,20,39,.513,11,21,.524,.683,6,7,.857,0,22,22,13,3,4,2,11,88
Marc Gasol,2017,C,32,MEM,6,6,240,39,83,.470,7,12,.583,32,71,.451,.512,31,33,.939,7,32,39,25,2,4,15,22,116
Pau Gasol,2017,C,36,SAS,16,7,365,50,114,.439,6,18,.333,44,96,.458,.465,17,24,.708,39,75,114,31,7,15,18,35,123
Paul George,2017,SF,26,IND,4,4,172,34,88,.386,18,42,.429,16,46,.348,.489,26,30,.867,5,30,35,29,7,2,13,13,112
Taj Gibson,2017,PF,31,OKC,5,5,118,21,35,.600,0,0,,21,35,.600,.600,7,8,.875,3,15,18,3,1,0,8,13,49
Manu GinÃ³bili*,2017,SG,39,SAS,16,1,284,40,97,.412,9,40,.225,31,57,.544,.459,17,23,.739,10,29,39,39,16,2,12,28,106
Rudy Gobert,2017,C,24,UTA,9,9,246,40,63,.635,0,0,,40,63,.635,.635,24,50,.480,22,67,89,11,9,12,9,30,104
Eric Gordon,2017,SG,28,HOU,11,2,358,51,121,.421,27,70,.386,24,51,.471,.533,13,18,.722,5,38,43,22,8,6,14,20,142
Marcin Gortat,2017,C,32,WAS,13,13,409,47,93,.505,0,0,,47,93,.505,.505,11,18,.611,52,91,143,24,5,20,17,40,105
Jerami Grant,2017,PF,22,OKC,5,0,111,19,31,.613,2,6,.333,17,25,.680,.645,6,7,.857,7,12,19,4,1,2,3,7,46
Jerian Grant,2017,PG,24,CHI,5,2,52,6,23,.261,1,9,.111,5,14,.357,.283,3,3,1.000,0,4,4,5,2,0,7,3,16
Danny Green,2017,SG,29,SAS,16,16,436,45,111,.405,26,76,.342,19,35,.543,.523,8,14,.571,13,44,57,23,10,15,17,30,124
Draymond Green,2017,PF,26,GSW,17,17,593,72,161,.447,32,78,.410,40,83,.482,.547,46,67,.687,20,135,155,110,31,28,36,60,222
Gerald Green,2017,SF,31,BOS,13,7,192,34,72,.472,21,45,.467,13,27,.481,.618,8,9,.889,2,18,20,9,3,1,7,21,97
JaMychal Green,2017,PF,26,MEM,6,2,118,17,36,.472,7,16,.438,10,20,.500,.569,3,3,1.000,3,17,20,2,0,0,4,21,44
Blake Griffin,2017,PF,27,LAC,3,3,99,25,51,.490,4,6,.667,21,45,.467,.529,7,7,1.000,3,15,18,7,2,1,6,2,61
Tim Hardaway Jr.,2017,SG,24,ATL,6,6,200,27,82,.329,11,42,.262,16,40,.400,.396,12,19,.632,3,13,16,7,3,0,10,13,77
James Harden,2017,PG,27,HOU,11,11,407,90,218,.413,32,115,.278,58,103,.563,.486,101,115,.878,7,53,60,93,21,5,59,43,313
Maurice Harkless,2017,SF,23,POR,4,4,99,10,34,.294,2,12,.167,8,22,.364,.324,7,8,.875,7,6,13,3,5,5,1,14,29
Montrezl Harrell,2017,C,23,HOU,5,0,21,1,3,.333,0,0,,1,3,.333,.333,3,6,.500,1,5,6,2,0,0,2,7,5
Andrew Harrison,2017,PG,22,MEM,6,0,119,13,29,.448,5,13,.385,8,16,.500,.534,8,9,.889,4,7,11,13,3,1,3,14,39
Spencer Hawes,2017,PF,28,MIL,3,0,17,2,5,.400,1,2,.500,1,3,.333,.500,0,0,,2,2,4,1,0,1,1,3,5
Gordon Hayward,2017,SF,26,UTA,11,11,411,83,188,.441,28,68,.412,55,120,.458,.516,71,76,.934,7,60,67,37,10,3,24,23,265
John Henson,2017,C,26,MIL,2,0,12,1,4,.250,0,0,,1,4,.250,.250,1,1,1.000,2,2,4,0,1,0,1,1,3
NenÃª,2017,C,34,HOU,9,0,161,36,51,.706,0,1,.000,36,50,.720,.706,18,31,.581,11,31,42,5,6,4,9,24,90
George Hill,2017,PG,30,UTA,8,8,281,46,98,.469,12,31,.387,34,67,.507,.531,21,29,.724,8,25,33,29,2,1,13,25,125
Rodney Hood,2017,SG,24,UTA,11,0,277,37,105,.352,13,50,.260,24,55,.436,.414,11,18,.611,1,29,30,12,5,0,10,30,98
Al Horford,2017,C,30,BOS,18,18,610,111,190,.584,27,52,.519,84,138,.609,.655,22,29,.759,31,87,118,97,15,14,33,33,271
Dwight Howard,2017,C,31,ATL,6,6,157,18,36,.500,0,0,,18,36,.500,.500,12,19,.632,18,46,64,8,6,5,11,21,48
Kris Humphries,2017,PF,31,ATL,1,0,3,0,0,,0,0,,0,0,,,0,0,,0,0,0,0,0,1,0,0,0
Serge Ibaka,2017,PF,27,TOR,10,10,307,60,130,.462,12,38,.316,48,92,.522,.508,11,13,.846,9,56,65,14,4,17,11,37,143
Andre Iguodala,2017,SF,33,GSW,16,0,419,46,101,.455,8,42,.190,38,59,.644,.495,15,26,.577,9,56,65,51,14,7,16,29,115
Ersan Ä°lyasova,2017,PF,29,ATL,6,0,90,8,23,.348,1,5,.200,7,18,.389,.370,7,9,.778,14,17,31,2,1,0,5,7,24
Joe Ingles,2017,SF,29,UTA,11,11,334,25,62,.403,15,41,.366,10,21,.476,.524,6,9,.667,2,39,41,36,22,5,16,28,71
Kyrie Irving,2017,PG,24,CLE,18,18,653,173,370,.468,44,118,.373,129,252,.512,.527,76,84,.905,13,38,51,95,23,8,48,38,466
LeBron James,2017,SF,32,CLE,18,18,744,217,384,.565,44,107,.411,173,277,.625,.622,113,162,.698,19,145,164,141,35,23,72,43,591
Richard Jefferson,2017,SF,36,CLE,14,0,179,16,38,.421,5,19,.263,11,19,.579,.487,18,28,.643,10,15,25,7,2,3,8,30,55
Brandon Jennings,2017,PG,27,WAS,13,0,178,14,36,.389,2,13,.154,12,23,.522,.417,7,8,.875,5,14,19,24,2,0,8,13,37
Jonas Jerebko,2017,PF,29,BOS,12,0,128,15,31,.484,5,15,.333,10,16,.625,.565,8,8,1.000,7,22,29,12,5,3,6,13,43
Amir Johnson,2017,PF,29,BOS,14,9,142,15,30,.500,1,3,.333,14,27,.519,.517,5,8,.625,17,13,30,3,4,6,6,24,36
Joe Johnson,2017,SF,35,UTA,11,2,326,58,133,.436,15,45,.333,43,88,.489,.492,11,15,.733,8,35,43,27,6,1,13,21,142
Wesley Johnson,2017,SF,29,LAC,3,0,11,0,0,,0,0,,0,0,,,1,2,.500,0,2,2,0,1,0,0,2,1
Dahntay Jones,2017,SF,36,CLE,10,0,33,5,10,.500,1,2,.500,4,8,.500,.550,5,5,1.000,1,6,7,1,0,1,1,7,16
Damian Jones,2017,C,21,GSW,4,0,21,3,7,.429,0,0,,3,7,.429,.429,1,2,.500,4,2,6,0,2,1,0,3,7
James Jones,2017,SF,36,CLE,8,0,30,1,5,.200,0,3,.000,1,2,.500,.200,0,0,,1,3,4,0,0,0,2,3,2
DeAndre Jordan,2017,C,28,LAC,7,7,264,43,61,.705,0,1,.000,43,60,.717,.705,22,56,.393,25,76,101,5,3,6,17,29,108
Cory Joseph,2017,PG,25,TOR,10,2,212,31,71,.437,9,22,.409,22,49,.449,.500,8,8,1.000,4,17,21,31,4,2,14,17,79
Kyle Korver,2017,SG,35,CLE,18,0,326,34,80,.425,27,69,.391,7,11,.636,.594,10,10,1.000,2,28,30,13,7,5,7,22,105
Joffrey Lauvergne,2017,C,25,CHI,3,0,26,4,11,.364,0,2,.000,4,9,.444,.364,6,6,1.000,5,4,9,5,0,0,2,1,14
Jake Layman,2017,SF,22,POR,2,0,16,2,4,.500,1,1,1.000,1,3,.333,.625,1,2,.500,0,1,1,1,1,0,0,2,6
David Lee,2017,PF,33,SAS,15,4,245,25,48,.521,0,1,.000,25,47,.532,.521,11,17,.647,20,37,57,11,4,5,6,20,61
Kawhi Leonard,2017,SF,25,SAS,12,12,429,106,202,.525,25,55,.455,81,147,.551,.587,95,102,.931,19,74,93,55,20,6,26,21,332
Meyers Leonard,2017,PF,24,POR,3,1,31,1,5,.200,0,4,.000,1,1,1.000,.200,0,0,,2,6,8,1,0,0,4,6,2
Damian Lillard,2017,PG,26,POR,4,4,151,39,90,.433,9,32,.281,30,58,.517,.483,24,25,.960,4,14,18,13,5,2,13,11,111
Shaun Livingston,2017,PG,31,GSW,14,0,220,34,59,.576,0,0,,34,59,.576,.576,5,7,.714,10,19,29,20,5,2,10,24,73
Robin Lopez,2017,C,28,CHI,6,6,162,34,52,.654,0,0,,34,52,.654,.654,8,8,1.000,28,15,43,5,3,6,8,13,76
Kevin Love,2017,PF,28,CLE,18,18,578,95,218,.436,50,111,.450,45,107,.421,.550,63,75,.840,36,155,191,30,21,16,31,46,303
Kyle Lowry,2017,PG,30,TOR,8,8,300,43,93,.462,13,38,.342,30,55,.545,.532,27,33,.818,3,22,25,47,12,4,17,26,126
Trey Lyles,2017,PF,21,UTA,2,0,10,3,7,.429,1,3,.333,2,4,.500,.500,0,0,,0,2,2,1,1,0,1,1,7
Sheldon Mac,2017,SG,24,WAS,7,0,17,5,9,.556,2,5,.400,3,4,.750,.667,2,2,1.000,0,2,2,0,0,0,1,1,14
Shelvin Mack,2017,PG,26,UTA,9,3,155,17,49,.347,7,15,.467,10,34,.294,.418,13,15,.867,3,22,25,18,4,0,9,14,54
Ian Mahinmi,2017,C,30,WAS,5,0,63,5,9,.556,0,0,,5,9,.556,.556,4,11,.364,3,8,11,6,1,6,3,17,14
Thon Maker,2017,C,19,MIL,6,6,116,12,31,.387,2,10,.200,10,21,.476,.419,9,11,.818,8,11,19,12,5,11,8,18,35
Jarell Martin,2017,PF,22,MEM,3,0,10,1,3,.333,0,0,,1,3,.333,.333,0,0,,2,2,4,0,1,0,0,2,2
Luc Mbah a Moute,2017,SF,30,LAC,7,7,224,17,43,.395,5,16,.313,12,27,.444,.453,14,20,.700,10,25,35,7,8,4,3,16,53
James Michael McAdoo,2017,PF,24,GSW,13,0,56,9,17,.529,2,5,.400,7,12,.583,.588,4,6,.667,5,8,13,0,2,2,1,5,24
Patrick McCaw,2017,SG,21,GSW,15,3,181,21,48,.438,8,23,.348,13,25,.520,.521,11,13,.846,10,23,33,16,9,3,3,14,61
CJ McCollum,2017,SG,25,POR,4,4,140,32,80,.400,11,22,.500,21,58,.362,.469,15,16,.938,8,16,24,4,4,2,15,10,90
Doug McDermott,2017,SF,25,OKC,5,0,66,9,18,.500,7,13,.538,2,5,.400,.694,0,0,,0,5,5,1,1,1,1,2,25
JaVale McGee,2017,C,29,GSW,16,1,149,41,56,.732,0,0,,41,56,.732,.732,13,18,.722,22,26,48,4,2,15,8,31,95
Jordan Mickey,2017,PF,22,BOS,2,0,18,2,5,.400,0,0,,2,5,.400,.400,0,0,,0,5,5,0,0,1,1,3,4
Khris Middleton,2017,SF,25,MIL,6,6,231,31,78,.397,7,19,.368,24,59,.407,.442,18,22,.818,0,28,28,32,12,0,11,17,87
C.J. Miles,2017,SF,29,IND,4,2,82,11,24,.458,5,16,.313,6,8,.750,.563,2,2,1.000,4,4,8,1,2,1,2,12,29
Patty Mills,2017,PG,28,SAS,16,6,416,57,140,.407,32,89,.360,25,51,.490,.521,19,22,.864,5,29,34,43,13,1,21,33,165
Paul Millsap,2017,PF,31,ATL,6,6,219,50,99,.505,3,17,.176,47,82,.573,.520,43,53,.811,9,47,56,26,10,4,23,19,146
Nikola MirotiÄ,2017,PF,25,CHI,6,6,162,17,50,.340,10,35,.286,7,15,.467,.440,8,10,.800,4,26,30,9,4,3,4,16,52
Greg Monroe,2017,C,26,MIL,6,0,141,27,51,.529,0,0,,27,51,.529,.529,25,30,.833,17,27,44,10,8,3,11,16,79
Markieff Morris,2017,PF,27,WAS,13,13,373,59,145,.407,14,38,.368,45,107,.421,.455,25,31,.806,18,65,83,22,12,17,21,46,157
Anthony Morrow,2017,SG,31,CHI,3,0,29,5,9,.556,0,0,,5,9,.556,.556,2,2,1.000,0,3,3,2,0,0,0,2,12
Dejounte Murray,2017,PG,20,SAS,11,2,168,23,61,.377,0,3,.000,23,58,.397,.377,17,25,.680,4,23,27,27,16,1,16,14,63
Mike Muscala,2017,C,25,ATL,6,0,81,5,18,.278,0,4,.000,5,14,.357,.278,7,8,.875,6,10,16,2,1,3,1,12,17
Shabazz Napier,2017,PG,25,POR,4,0,47,8,19,.421,5,11,.455,3,8,.375,.553,6,8,.750,1,3,4,3,2,0,0,6,27
Raul Neto,2017,PG,24,UTA,9,0,60,8,13,.615,3,6,.500,5,7,.714,.731,4,4,1.000,0,7,7,4,1,1,3,8,23
Lucas Nogueira,2017,C,24,TOR,3,0,7,1,2,.500,0,0,,1,2,.500,.500,1,2,.500,2,3,5,0,0,0,0,1,3
Jusuf NurkiÄ,2017,C,22,POR,1,1,17,1,3,.333,0,1,.000,1,2,.500,.333,0,0,,0,11,11,4,0,1,3,1,2
Daniel Ochefu,2017,C,23,WAS,4,0,5,0,1,.000,0,0,,0,1,.000,.000,0,0,,0,1,1,0,0,0,1,1,0
Victor Oladipo,2017,SG,24,OKC,5,5,181,21,61,.344,6,25,.240,15,36,.417,.393,6,6,1.000,2,26,28,10,7,3,6,17,54
Kelly Olynyk,2017,C,25,BOS,18,2,346,64,125,.512,15,47,.319,49,78,.628,.572,22,30,.733,14,43,57,34,13,14,22,47,165
Kelly Oubre Jr.,2017,SF,21,WAS,12,0,184,26,61,.426,11,30,.367,15,31,.484,.516,7,10,.700,9,19,28,4,10,5,7,38,70
Zaza Pachulia,2017,C,32,GSW,15,15,212,32,60,.533,0,1,.000,32,59,.542,.533,13,17,.765,18,39,57,12,8,4,14,32,77
Tony Parker,2017,PG,34,SAS,8,8,211,51,97,.526,11,19,.579,40,78,.513,.582,14,14,1.000,2,18,20,25,4,0,12,10,127
Patrick Patterson,2017,PF,27,TOR,10,1,185,10,36,.278,8,26,.308,2,10,.200,.389,6,6,1.000,1,19,20,20,7,2,6,4,34
Chris Paul,2017,PG,31,LAC,7,7,260,67,135,.496,14,38,.368,53,97,.546,.548,29,33,.879,4,31,35,69,12,1,19,24,177
Cameron Payne,2017,PG,22,CHI,1,0,4,1,2,.500,1,1,1.000,0,1,.000,.750,0,0,,0,1,1,0,0,0,1,0,3
Paul Pierce*,2017,SF,39,LAC,7,0,101,8,18,.444,4,10,.400,4,8,.500,.556,1,1,1.000,2,12,14,7,2,0,4,11,21
Jakob Poeltl,2017,C,21,TOR,6,0,26,5,11,.455,0,0,,5,11,.455,.455,0,2,.000,6,6,12,0,1,1,0,3,10
Otto Porter Jr.,2017,SF,23,WAS,13,13,428,58,109,.532,11,39,.282,47,70,.671,.583,31,35,.886,15,75,90,23,21,7,10,26,158
Bobby Portis,2017,PF,21,CHI,6,0,121,17,33,.515,6,13,.462,11,20,.550,.606,0,0,,5,31,36,7,3,3,6,10,40
Norman Powell,2017,SG,23,TOR,9,5,227,35,82,.427,15,34,.441,20,48,.417,.518,20,24,.833,5,23,28,14,10,3,15,25,105
Taurean Prince,2017,SF,22,ATL,6,6,187,29,52,.558,4,14,.286,25,38,.658,.596,5,5,1.000,7,25,32,8,2,1,7,9,67
Tim Quarterman,2017,SG,22,POR,2,0,7,1,2,.500,1,2,.500,0,0,,.750,0,0,,0,0,0,1,0,0,0,1,3
Zach Randolph,2017,PF,35,MEM,6,4,191,35,83,.422,1,7,.143,34,76,.447,.428,8,11,.727,9,40,49,4,5,2,7,14,79
J.J. Redick,2017,SG,32,LAC,7,7,206,19,50,.380,9,26,.346,10,24,.417,.470,17,20,.850,0,12,12,6,2,0,13,17,64
Austin Rivers,2017,SG,24,LAC,3,2,90,9,26,.346,4,13,.308,5,13,.385,.423,2,2,1.000,1,7,8,2,1,1,5,6,24
Andre Roberson,2017,SF,25,OKC,5,5,185,24,46,.522,7,17,.412,17,29,.586,.598,3,21,.143,18,13,31,9,12,17,7,15,58
Glenn Robinson III,2017,SF,23,IND,3,0,31,6,6,1.000,2,2,1.000,4,4,1.000,1.167,1,2,.500,0,3,3,1,0,0,0,2,15
Rajon Rondo,2017,PG,30,CHI,2,2,67,11,26,.423,0,6,.000,11,20,.550,.423,1,2,.500,7,10,17,20,7,1,4,6,23
Terry Rozier,2017,PG,22,BOS,17,0,277,33,82,.402,14,38,.368,19,44,.432,.488,16,20,.800,12,32,44,32,11,4,10,20,96
Domantas Sabonis,2017,PF,20,OKC,2,0,6,0,3,.000,0,1,.000,0,2,.000,.000,4,4,1.000,0,2,2,0,1,1,0,4,4
TomÃ¡Å¡ SatoranskÃ½,2017,SG,25,WAS,10,0,36,3,6,.500,0,0,,3,6,.500,.500,2,5,.400,1,4,5,6,1,0,2,4,8
Dennis SchrÃ¶der,2017,PG,23,ATL,6,6,211,50,110,.455,17,40,.425,33,70,.471,.532,31,37,.838,4,10,14,46,6,0,10,19,148
Thabo Sefolosha,2017,SF,32,ATL,4,0,9,0,1,.000,0,0,,0,1,.000,.000,1,4,.250,0,0,0,0,0,0,0,1,1
Wayne Selden,2017,SG,22,MEM,6,2,106,9,26,.346,2,11,.182,7,15,.467,.385,3,4,.750,3,6,9,7,1,1,2,8,23
Kevin SÃ©raphin,2017,PF,27,IND,4,0,59,12,26,.462,0,0,,12,26,.462,.462,5,7,.714,8,6,14,4,0,2,4,10,29
Iman Shumpert,2017,SG,26,CLE,17,0,275,25,60,.417,10,26,.385,15,34,.441,.500,14,17,.824,6,41,47,16,10,3,6,32,74
Pascal Siakam,2017,PF,22,TOR,2,0,10,0,2,.000,0,0,,0,2,.000,.000,0,0,,2,1,3,1,1,0,0,1,0
Jonathon Simmons,2017,SG,27,SAS,15,4,306,62,136,.456,13,37,.351,49,99,.495,.504,21,31,.677,9,19,28,29,9,2,11,30,158
Kyle Singler,2017,SF,28,OKC,1,0,10,0,1,.000,0,0,,0,1,.000,.000,0,0,,0,1,1,0,0,0,0,2,0
Marcus Smart,2017,SG,22,BOS,18,3,538,47,134,.351,29,73,.397,18,61,.295,.459,32,50,.640,23,62,85,85,27,16,38,51,155
J.R. Smith,2017,SG,31,CLE,18,18,487,50,99,.505,40,80,.500,10,19,.526,.707,5,11,.455,5,37,42,13,13,6,12,41,145
Jason Smith,2017,C,30,WAS,13,0,157,19,39,.487,3,10,.300,16,29,.552,.526,10,14,.714,10,19,29,4,2,7,10,30,51
Tony Snell,2017,SG,25,MIL,6,6,185,22,44,.500,16,31,.516,6,13,.462,.682,0,0,,2,12,14,9,1,1,2,17,60
Marreese Speights,2017,C,29,LAC,7,2,98,16,37,.432,7,20,.350,9,17,.529,.527,7,10,.700,4,16,20,3,2,3,3,13,46
Lance Stephenson,2017,SG,26,IND,4,0,107,27,53,.509,7,18,.389,20,35,.571,.575,3,4,.750,1,20,21,11,2,0,4,11,64
Isaiah Taylor,2017,PG,22,HOU,3,0,10,0,2,.000,0,1,.000,0,1,.000,.000,0,0,,1,1,2,1,0,0,0,1,0
Jeff Teague,2017,PG,28,IND,4,4,142,22,45,.489,9,17,.529,13,28,.464,.589,15,18,.833,0,13,13,25,4,3,8,12,68
Mirza TeletoviÄ,2017,PF,31,MIL,3,0,27,1,6,.167,1,4,.250,0,2,.000,.250,0,0,,0,3,3,0,1,0,1,3,3
Jason Terry,2017,SG,39,MIL,6,0,68,6,18,.333,2,10,.200,4,8,.500,.389,1,1,1.000,2,6,8,5,3,1,2,7,15
Isaiah Thomas,2017,PG,27,BOS,15,15,521,111,261,.425,36,108,.333,75,153,.490,.494,91,111,.820,5,42,47,100,13,2,50,35,349
Klay Thompson,2017,SG,26,GSW,17,17,596,94,237,.397,41,106,.387,53,131,.405,.483,26,33,.788,11,55,66,35,14,5,24,44,255
Tristan Thompson,2017,C,25,CLE,18,18,562,54,92,.587,0,0,,54,92,.587,.587,40,60,.667,69,81,150,26,9,13,21,36,148
P.J. Tucker,2017,SF,31,TOR,10,1,251,18,49,.367,9,28,.321,9,21,.429,.459,5,8,.625,15,42,57,11,6,3,8,27,50
Evan Turner,2017,SF,28,POR,4,4,124,12,33,.364,5,15,.333,7,18,.389,.439,12,16,.750,3,20,23,15,7,2,7,7,41
Myles Turner,2017,C,20,IND,4,4,133,19,44,.432,0,6,.000,19,38,.500,.432,5,8,.625,6,21,27,3,7,5,6,15,43
Jonas ValanÄiÅ«nas,2017,C,24,TOR,10,6,226,44,81,.543,0,1,.000,44,80,.550,.543,24,33,.727,9,58,67,2,2,6,13,22,112
Denzel Valentine,2017,SG,23,CHI,4,0,22,2,6,.333,1,4,.250,1,2,.500,.417,0,0,,0,8,8,2,0,1,2,1,5
Fred VanVleet,2017,PG,22,TOR,7,0,29,6,9,.667,2,5,.400,4,4,1.000,.778,0,0,,0,1,1,4,1,0,1,3,14
Rashad Vaughn,2017,SG,20,MIL,3,0,10,2,4,.500,2,2,1.000,0,2,.000,.750,0,0,,0,0,0,0,0,0,0,0,6
Noah Vonleh,2017,PF,21,POR,4,2,100,8,18,.444,0,0,,8,18,.444,.444,2,5,.400,9,20,29,8,1,3,6,11,18
Dwyane Wade,2017,SG,35,CHI,6,6,190,32,86,.372,6,17,.353,26,69,.377,.407,20,21,.952,6,24,30,24,5,8,10,8,90
John Wall,2017,PG,26,WAS,13,13,507,127,281,.452,21,61,.344,106,220,.482,.489,78,93,.839,7,41,48,134,22,15,55,26,353
David West,2017,C,36,GSW,17,0,221,34,59,.576,1,2,.500,33,57,.579,.585,7,9,.778,7,39,46,36,7,13,10,26,76
Russell Westbrook,2017,PG,28,OKC,5,5,194,59,152,.388,13,49,.265,46,103,.447,.431,56,70,.800,9,49,58,54,12,2,30,16,187
Deron Williams,2017,PG,32,CLE,18,0,262,28,64,.438,12,31,.387,16,33,.485,.531,10,11,.909,3,20,23,38,10,1,17,29,78
Derrick Williams,2017,PF,25,CLE,8,0,38,8,15,.533,3,5,.600,5,10,.500,.633,2,2,1.000,1,2,3,4,0,1,3,0,21
Lou Williams,2017,SG,30,HOU,11,0,272,50,118,.424,12,39,.308,38,79,.481,.475,26,29,.897,7,23,30,14,7,1,14,17,138
Troy Williams,2017,SF,22,HOU,5,0,19,0,9,.000,0,5,.000,0,4,.000,.000,1,2,.500,2,5,7,1,0,0,2,0,1
Kyle Wiltjer,2017,PF,24,HOU,1,0,5,1,1,1.000,1,1,1.000,0,0,,1.500,0,0,,0,0,0,0,0,0,0,0,3
Jeff Withey,2017,C,26,UTA,3,0,21,2,4,.500,0,0,,2,4,.500,.500,1,2,.500,3,1,4,1,1,1,0,5,5
Brandan Wright,2017,PF,29,MEM,2,0,12,2,5,.400,0,0,,2,5,.400,.400,0,0,,1,1,2,0,0,2,1,0,4
Delon Wright,2017,PG,24,TOR,9,0,92,9,17,.529,2,6,.333,7,11,.636,.588,5,7,.714,4,9,13,13,4,1,5,4,25
James Young,2017,SG,21,BOS,10,0,39,5,15,.333,5,14,.357,0,1,.000,.500,0,0,,1,6,7,3,0,0,1,2,15
Thaddeus Young,2017,PF,28,IND,4,4,140,21,39,.538,1,4,.250,20,35,.571,.551,5,10,.500,22,14,36,10,8,1,6,11,48
Tyler Zeller,2017,C,27,BOS,11,0,78,13,25,.520,0,0,,13,25,.520,.520,6,8,.750,8,11,19,8,0,2,4,7,32
Paul Zipser,2017,SF,22,CHI,6,0,136,15,33,.455,6,16,.375,9,17,.529,.545,8,8,1.000,3,18,21,3,1,1,7,12,44
Ãlex Abrines,2018,SG,24,OKC,6,0,110,8,20,.400,6,13,.462,2,7,.286,.550,2,2,1.000,3,13,16,2,5,2,1,11,24
Steven Adams,2018,C,24,OKC,6,6,200,27,46,.587,0,0,,27,46,.587,.587,9,13,.692,19,26,45,9,4,4,4,15,63
Bam Adebayo,2018,C,20,MIA,5,0,77,7,15,.467,0,1,.000,7,14,.500,.467,3,14,.214,9,11,20,0,0,2,2,8,17
LaMarcus Aldridge,2018,C,32,SAS,5,5,177,37,80,.463,3,5,.600,34,75,.453,.481,41,42,.976,13,33,46,12,3,2,9,9,118
Al-Farouq Aminu,2018,PF,27,POR,4,4,131,27,52,.519,13,30,.433,14,22,.636,.644,2,2,1.000,12,24,36,5,4,2,6,8,69
Justin Anderson,2018,SF,24,PHI,7,0,33,3,8,.375,2,7,.286,1,1,1.000,.500,0,0,,1,8,9,0,1,0,2,8,8
Kyle Anderson,2018,SF,24,SAS,5,1,73,12,20,.600,0,4,.000,12,16,.750,.600,3,4,.750,5,8,13,3,6,1,3,10,27
Ryan Anderson,2018,PF,29,HOU,11,0,95,7,20,.350,5,15,.333,2,5,.400,.475,0,0,,4,9,13,6,3,1,3,10,19
Giannis Antetokounmpo,2018,PF,23,MIL,7,7,280,69,121,.570,4,14,.286,65,107,.607,.587,38,55,.691,8,59,67,44,10,6,17,28,180
Carmelo Anthony,2018,PF,33,OKC,6,6,194,27,72,.375,6,28,.214,21,44,.477,.417,11,15,.733,3,31,34,2,10,4,6,14,71
OG Anunoby,2018,SF,20,TOR,10,10,238,29,52,.558,13,29,.448,16,23,.696,.683,8,11,.727,9,12,21,7,6,4,6,23,79
Trevor Ariza,2018,SF,32,HOU,17,17,582,50,139,.360,26,91,.286,24,48,.500,.453,23,31,.742,9,56,65,22,19,2,10,44,149
Luke Babbitt,2018,SF,28,MIA,2,0,3,0,1,.000,0,0,,0,1,.000,.000,0,0,,0,0,0,0,0,0,0,0,0
Wade Baldwin,2018,PG,21,POR,4,0,19,1,4,.250,1,1,1.000,0,3,.000,.375,1,2,.500,0,3,3,3,1,1,3,1,4
Jerryd Bayless,2018,SG,29,PHI,1,0,2,0,0,,0,0,,0,0,,,0,0,,0,0,0,0,0,0,0,0,0
Aron Baynes,2018,C,31,BOS,19,12,389,45,89,.506,11,23,.478,34,66,.515,.567,13,18,.722,45,73,118,19,4,11,8,43,114
Bradley Beal,2018,SG,24,WAS,6,6,216,49,108,.454,21,45,.467,28,63,.444,.551,20,23,.870,2,18,20,17,7,2,15,19,139
Marco Belinelli,2018,SG,31,PHI,10,0,273,43,106,.406,16,46,.348,27,60,.450,.481,27,31,.871,1,20,21,20,7,0,4,20,129
Jordan Bell,2018,C,23,GSW,17,0,173,17,32,.531,0,1,.000,17,31,.548,.531,7,14,.500,15,32,47,15,6,9,6,18,41
DÄvis BertÄns,2018,PF,25,SAS,5,0,82,3,18,.167,3,16,.188,0,2,.000,.250,8,11,.727,1,10,11,6,2,0,1,10,17
Nemanja Bjelica,2018,PF,29,MIN,5,0,47,7,16,.438,4,7,.571,3,9,.333,.563,5,7,.714,4,11,15,3,3,0,1,6,23
Tarik Black,2018,C,26,HOU,7,0,19,1,4,.250,0,0,,1,4,.250,.250,0,0,,2,4,6,2,0,1,1,5,2
Eric Bledsoe,2018,PG,28,MIL,7,7,225,37,84,.440,7,22,.318,30,62,.484,.482,14,20,.700,3,22,25,26,7,6,15,19,95
Bojan BogdanoviÄ,2018,SF,28,IND,7,7,238,32,81,.395,17,45,.378,15,36,.417,.500,6,10,.600,1,23,24,13,6,0,13,23,87
Trevor Booker,2018,PF,30,IND,7,0,64,6,10,.600,0,1,.000,6,9,.667,.600,6,7,.857,5,13,18,0,1,1,1,12,18
Tony Bradley,2018,C,20,UTA,1,0,2,1,2,.500,0,0,,1,2,.500,.500,0,0,,1,0,1,0,0,0,0,0,2
Corey Brewer,2018,SG,31,OKC,6,6,151,13,25,.520,5,11,.455,8,14,.571,.620,6,6,1.000,4,9,13,5,7,5,2,17,37
Malcolm Brogdon,2018,PG,25,MIL,7,5,186,24,55,.436,5,19,.263,19,36,.528,.482,8,10,.800,3,21,24,17,1,0,12,14,61
Aaron Brooks,2018,PG,33,MIN,2,0,3,2,3,.667,0,1,.000,2,2,1.000,.667,0,2,.000,0,0,0,0,0,0,0,0,4
Jaylen Brown,2018,SG,21,BOS,18,15,583,124,266,.466,44,112,.393,80,154,.519,.549,32,50,.640,16,71,87,26,14,10,23,58,324
Lorenzo Brown,2018,PG,27,TOR,4,0,29,3,10,.300,2,5,.400,1,5,.200,.400,1,2,.500,1,5,6,2,0,1,1,2,9
Sterling Brown,2018,SG,22,MIL,3,0,13,3,5,.600,1,3,.333,2,2,1.000,.700,0,0,,1,1,2,0,1,0,0,2,7
Alec Burks,2018,SG,26,UTA,9,0,120,30,64,.469,9,20,.450,21,44,.477,.539,13,15,.867,2,22,24,17,4,1,8,9,82
Jimmy Butler,2018,SG,28,MIN,5,5,170,28,63,.444,8,17,.471,20,46,.435,.508,15,18,.833,3,27,30,20,4,1,5,9,79
JosÃ© CalderÃ³n,2018,PG,36,CLE,13,3,104,9,26,.346,4,18,.222,5,8,.625,.423,2,2,1.000,2,9,11,9,5,0,5,15,24
Clint Capela,2018,C,23,HOU,17,17,520,95,144,.660,0,0,,95,144,.660,.660,26,55,.473,61,136,197,22,14,36,15,38,216
Ian Clark,2018,SG,26,NOP,9,0,190,28,66,.424,10,28,.357,18,38,.474,.500,4,4,1.000,2,8,10,11,8,2,9,20,70
Jordan Clarkson,2018,SG,25,CLE,19,0,286,37,123,.301,11,46,.239,26,77,.338,.346,5,6,.833,9,23,32,13,8,3,13,21,90
Zach Collins,2018,C,20,POR,4,0,70,11,30,.367,3,14,.214,8,16,.500,.417,3,4,.750,3,9,12,6,3,2,2,10,28
Darren Collison,2018,PG,30,IND,7,7,214,31,68,.456,8,23,.348,23,45,.511,.515,9,12,.750,1,20,21,33,7,0,9,7,79
Pat Connaughton,2018,SG,25,POR,4,0,59,6,15,.400,2,10,.200,4,5,.800,.467,2,2,1.000,2,2,4,6,1,1,1,9,16
Quinn Cook,2018,PG,24,GSW,17,0,175,30,67,.448,7,31,.226,23,36,.639,.500,14,17,.824,2,21,23,11,4,2,5,13,81
Robert Covington,2018,SF,27,PHI,10,8,281,27,83,.325,15,48,.313,12,35,.343,.416,12,16,.750,12,41,53,25,11,9,11,30,81
Jamal Crawford,2018,SG,37,MIN,5,0,123,21,47,.447,7,17,.412,14,30,.467,.521,10,13,.769,1,12,13,12,5,0,5,6,59
Jordan Crawford,2018,SG,29,NOP,2,0,15,8,13,.615,3,8,.375,5,5,1.000,.731,0,0,,0,4,4,1,1,0,3,1,19
Jae Crowder,2018,SF,27,UTA,11,2,323,35,108,.324,22,66,.333,13,42,.310,.426,18,28,.643,4,52,56,19,15,2,14,25,110
Stephen Curry,2018,PG,29,GSW,15,14,555,137,304,.451,64,162,.395,73,142,.514,.556,45,47,.957,9,82,91,81,26,11,43,38,383
Anthony Davis,2018,PF,24,NOP,9,9,358,106,204,.520,6,22,.273,100,182,.549,.534,53,64,.828,24,97,121,15,18,21,23,30,271
Ed Davis,2018,C,28,POR,4,0,71,5,10,.500,0,0,,5,10,.500,.500,1,4,.250,5,27,32,0,0,1,4,7,11
Matthew Dellavedova,2018,PG,27,MIL,6,0,78,4,12,.333,2,9,.222,2,3,.667,.417,2,2,1.000,1,4,5,16,2,0,6,6,12
DeMar DeRozan,2018,SG,28,TOR,10,10,354,87,199,.437,10,35,.286,77,164,.470,.462,43,53,.811,6,30,36,40,5,6,23,24,227
Cheick Diallo,2018,PF,21,NOP,7,0,48,5,12,.417,0,0,,5,12,.417,.417,0,0,,4,5,9,0,1,1,1,9,10
Gorgui Dieng,2018,C,28,MIN,5,0,70,6,18,.333,2,5,.400,4,13,.308,.389,3,4,.750,3,15,18,4,2,4,1,6,17
Goran DragiÄ,2018,PG,31,MIA,5,5,156,35,75,.467,8,21,.381,27,54,.500,.520,15,22,.682,3,10,13,23,5,0,15,15,93
Kevin Durant,2018,SF,29,GSW,21,21,807,212,435,.487,47,138,.341,165,297,.556,.541,137,152,.901,13,150,163,99,15,25,50,43,608
Wayne Ellington,2018,SG,30,MIA,5,0,101,12,35,.343,12,30,.400,0,5,.000,.514,3,3,1.000,1,7,8,3,2,2,3,9,39
Joel Embiid,2018,C,23,PHI,8,8,278,60,138,.435,8,29,.276,52,109,.477,.464,43,61,.705,23,78,101,24,7,14,29,31,171
Dante Exum,2018,PG,22,UTA,10,0,114,20,41,.488,2,7,.286,18,34,.529,.512,9,12,.750,4,10,14,10,1,1,15,15,51
Derrick Favors,2018,C,26,UTA,11,9,286,42,68,.618,2,5,.400,40,63,.635,.632,16,33,.485,20,37,57,13,8,11,10,17,102
Raymond Felton,2018,PG,33,OKC,6,0,79,12,31,.387,7,14,.500,5,17,.294,.500,0,2,.000,2,11,13,9,4,2,5,7,31
Terrance Ferguson,2018,SG,19,OKC,3,0,6,1,1,1.000,1,1,1.000,0,0,,1.500,0,0,,1,0,1,1,0,0,0,2,3
Bryn Forbes,2018,SG,24,SAS,4,0,54,5,17,.294,2,9,.222,3,8,.375,.353,5,7,.714,1,2,3,2,0,0,0,3,17
Tim Frazier,2018,PG,27,WAS,2,0,6,0,1,.000,0,0,,0,1,.000,.000,0,0,,0,1,1,3,1,0,0,2,0
Markelle Fultz,2018,SG,19,PHI,3,0,23,1,7,.143,0,0,,1,7,.143,.143,3,4,.750,0,3,3,5,2,0,1,4,5
Pau Gasol,2018,C,37,SAS,5,0,90,10,20,.500,1,3,.333,9,17,.529,.525,9,10,.900,2,22,24,14,0,1,6,5,30
Rudy Gay,2018,PF,31,SAS,5,4,160,26,65,.400,4,18,.222,22,47,.468,.431,5,9,.556,9,19,28,11,8,1,6,16,61
Paul George,2018,SF,27,OKC,6,6,251,49,120,.408,19,52,.365,30,68,.441,.488,31,36,.861,4,32,36,16,8,4,24,17,148
Marcus Georges-Hunt,2018,SG,23,MIN,2,0,3,0,1,.000,0,0,,0,1,.000,.000,0,0,,1,0,1,0,0,0,0,0,0
Taj Gibson,2018,PF,32,MIN,5,5,123,14,22,.636,0,0,,14,22,.636,.636,3,3,1.000,7,13,20,2,1,2,4,8,31
Manu GinÃ³bili*,2018,SG,40,SAS,5,0,107,15,37,.405,6,18,.333,9,19,.474,.486,9,11,.818,1,14,15,16,7,1,7,13,45
Rudy Gobert,2018,C,25,UTA,11,11,383,55,84,.655,0,0,,55,84,.655,.655,35,58,.603,43,75,118,11,10,25,21,34,145
Eric Gordon,2018,SG,29,HOU,17,2,549,84,221,.380,43,130,.331,41,91,.451,.477,51,61,.836,9,36,45,28,10,8,24,29,262
Marcin Gortat,2018,C,33,WAS,6,6,160,24,43,.558,0,0,,24,43,.558,.558,4,7,.571,13,25,38,6,0,2,6,15,52
Jerami Grant,2018,PF,23,OKC,6,0,133,18,35,.514,2,8,.250,16,27,.593,.543,5,11,.455,8,12,20,6,4,3,6,15,43
Danny Green,2018,SG,30,SAS,5,5,103,8,30,.267,5,20,.250,3,10,.300,.350,0,0,,4,7,11,1,1,4,2,8,21
Draymond Green,2018,PF,27,GSW,21,21,819,83,192,.432,21,79,.266,62,113,.549,.487,39,49,.796,42,180,222,171,41,31,63,75,226
Gerald Green,2018,SG,32,HOU,17,0,272,37,94,.394,27,72,.375,10,22,.455,.537,6,7,.857,6,44,50,1,4,7,10,27,107
Jeff Green,2018,PF,31,CLE,22,2,523,58,142,.408,21,70,.300,37,72,.514,.482,33,46,.717,7,46,53,32,7,15,17,36,170
James Harden,2018,SG,28,HOU,17,17,621,158,385,.410,52,174,.299,106,211,.502,.478,118,133,.887,14,75,89,116,38,11,65,46,486
Maurice Harkless,2018,SF,24,POR,2,1,53,7,13,.538,2,6,.333,5,7,.714,.615,0,0,,3,5,8,4,0,1,1,4,16
John Henson,2018,C,27,MIL,2,2,74,9,13,.692,0,0,,9,13,.692,.692,1,2,.500,4,8,12,5,0,7,4,4,19
NenÃª,2018,C,35,HOU,11,0,107,12,20,.600,0,0,,12,20,.600,.600,7,11,.636,6,22,28,5,2,5,8,18,31
George Hill,2018,PG,31,CLE,19,18,557,59,131,.450,16,51,.314,43,80,.538,.511,41,53,.774,13,28,41,42,10,8,22,52,175
Solomon Hill,2018,SF,26,NOP,9,0,114,9,25,.360,6,16,.375,3,9,.333,.480,9,10,.900,6,11,17,7,1,1,6,17,33
Jrue Holiday,2018,SG,27,NOP,9,9,348,88,170,.518,16,50,.320,72,120,.600,.565,21,30,.700,9,42,51,57,10,5,23,22,213
Richaun Holmes,2018,C,24,PHI,3,0,11,0,1,.000,0,0,,0,1,.000,.000,0,0,,0,1,1,1,0,0,0,3,0
Rodney Hood,2018,SG,25,CLE,17,1,260,39,92,.424,4,24,.167,35,68,.515,.446,9,12,.750,7,24,31,18,5,4,13,30,91
Al Horford,2018,C,31,BOS,19,19,679,111,204,.544,15,43,.349,96,161,.596,.581,62,75,.827,32,125,157,63,19,22,32,39,299
Josh Huestis,2018,PF,26,OKC,4,0,19,1,2,.500,0,0,,1,2,.500,.500,1,2,.500,0,3,3,0,1,1,0,3,3
Serge Ibaka,2018,PF,28,TOR,10,9,260,30,72,.417,9,24,.375,21,48,.438,.479,18,22,.818,13,46,59,11,1,13,16,21,87
Andre Iguodala,2018,SF,34,GSW,15,12,401,42,85,.494,14,37,.378,28,48,.583,.576,24,34,.706,11,57,68,41,21,7,14,29,122
Ersan Ä°lyasova,2018,PF,30,PHI,10,1,233,36,84,.429,9,31,.290,27,53,.509,.482,12,21,.571,26,50,76,13,7,4,10,25,93
Joe Ingles,2018,SF,30,UTA,11,11,382,57,121,.471,35,77,.455,22,44,.500,.616,11,17,.647,5,43,48,37,6,2,26,29,160
Aaron Jackson,2018,PG,31,HOU,7,0,17,2,4,.500,0,2,.000,2,2,1.000,.500,1,2,.500,2,2,4,2,0,0,2,2,5
LeBron James,2018,PF,33,CLE,22,22,922,275,510,.539,39,114,.342,236,396,.596,.577,159,213,.746,31,169,200,198,30,23,94,52,748
Brandon Jennings,2018,PG,28,MIL,1,0,5,0,2,.000,0,2,.000,0,0,,.000,2,2,1.000,0,0,0,0,0,0,1,0,2
Jonas Jerebko,2018,PF,30,UTA,10,0,79,8,19,.421,1,6,.167,7,13,.538,.447,2,2,1.000,4,12,16,3,3,0,1,9,19
Amir Johnson,2018,C,30,PHI,8,1,94,11,21,.524,0,0,,11,21,.524,.524,4,5,.800,14,9,23,9,2,1,3,10,26
Dakari Johnson,2018,C,22,OKC,2,0,3,0,0,,0,0,,0,0,,,0,0,,0,0,0,0,0,0,0,0,0
James Johnson,2018,PF,30,MIA,5,5,161,23,42,.548,7,13,.538,16,29,.552,.631,9,14,.643,3,27,30,24,6,6,10,17,62
Joe Johnson,2018,SF,36,HOU,8,0,54,6,17,.353,0,3,.000,6,14,.429,.353,0,0,,0,10,10,3,0,1,3,4,12
Tyler Johnson,2018,PG,25,MIA,5,5,81,14,26,.538,6,10,.600,8,16,.500,.654,6,7,.857,1,7,8,4,2,0,2,14,40
Damian Jones,2018,C,22,GSW,4,0,11,1,2,.500,0,0,,1,2,.500,.500,2,3,.667,1,2,3,0,0,0,3,4,4
Tyus Jones,2018,PG,21,MIN,4,0,55,2,7,.286,0,2,.000,2,5,.400,.286,0,0,,0,9,9,8,1,0,1,0,4
Cory Joseph,2018,PG,26,IND,7,0,143,12,33,.364,3,11,.273,9,22,.409,.409,6,6,1.000,2,15,17,21,9,2,4,10,33
Furkan Korkmaz,2018,SG,20,PHI,1,0,2,1,1,1.000,1,1,1.000,0,0,,1.500,0,0,,0,0,0,0,0,0,0,1,3
Kyle Korver,2018,SG,36,CLE,22,11,505,59,141,.418,45,109,.413,14,32,.438,.578,19,22,.864,6,46,52,19,9,9,14,44,182
Shane Larkin,2018,PG,25,BOS,11,0,154,16,35,.457,4,13,.308,12,22,.545,.514,5,5,1.000,1,10,11,20,5,0,6,15,41
Joffrey Lauvergne,2018,C,26,SAS,1,0,6,1,1,1.000,0,0,,1,1,1.000,1.000,0,0,,0,1,1,0,0,0,0,0,2
Ty Lawson,2018,PG,30,WAS,5,0,96,9,26,.346,5,8,.625,4,18,.222,.442,6,6,1.000,2,11,13,15,3,0,3,6,29
Jake Layman,2018,SF,23,POR,1,0,8,3,3,1.000,0,0,,3,3,1.000,1.000,0,0,,0,1,1,1,2,0,0,0,6
T.J. Leaf,2018,PF,20,IND,1,0,4,0,0,,0,0,,0,0,,,0,0,,0,0,0,0,0,0,0,0,0
Meyers Leonard,2018,C,25,POR,2,0,8,4,4,1.000,0,0,,4,4,1.000,1.000,0,0,,0,4,4,0,0,0,0,0,8
DeAndre Liggins,2018,SG,29,NOP,3,0,14,0,1,.000,0,0,,0,1,.000,.000,1,2,.500,0,1,1,0,0,0,2,0,1
Damian Lillard,2018,PG,27,POR,4,4,162,25,71,.352,9,30,.300,16,41,.390,.415,15,17,.882,3,15,18,19,5,0,16,8,74
Shaun Livingston,2018,PG,32,GSW,21,0,362,59,110,.536,0,1,.000,59,109,.541,.536,22,25,.880,11,36,47,31,7,1,16,33,140
Kevon Looney,2018,C,21,GSW,21,5,387,39,72,.542,0,2,.000,39,70,.557,.542,8,21,.381,42,47,89,19,14,8,8,50,86
Kevin Love,2018,C,29,CLE,21,21,660,109,278,.392,36,106,.340,73,172,.424,.457,59,64,.922,49,166,215,34,15,8,41,58,313
Kyle Lowry,2018,PG,31,TOR,10,10,361,60,118,.508,28,63,.444,32,55,.582,.627,26,32,.813,2,41,43,85,15,0,31,33,174
Ian Mahinmi,2018,C,31,WAS,6,0,52,10,14,.714,0,0,,10,14,.714,.714,10,11,.909,4,7,11,1,4,5,1,10,30
Thon Maker,2018,C,20,MIL,6,2,130,11,28,.393,6,20,.300,5,8,.625,.500,5,7,.714,6,17,23,5,2,11,4,17,33
Luc Mbah a Moute,2018,PF,31,HOU,9,0,149,9,36,.250,3,15,.200,6,21,.286,.292,4,7,.571,3,19,22,3,6,4,6,8,25
Patrick McCaw,2018,SG,22,GSW,6,0,16,1,2,.500,0,1,.000,1,1,1.000,.500,2,2,1.000,1,2,3,0,2,0,0,1,4
CJ McCollum,2018,SG,26,POR,4,4,155,40,77,.519,11,26,.423,29,51,.569,.591,10,13,.769,0,8,8,14,5,1,9,11,101
T.J. McConnell,2018,PG,25,PHI,10,2,155,25,36,.694,2,3,.667,23,33,.697,.722,3,5,.600,6,20,26,23,6,0,6,13,55
JaVale McGee,2018,C,30,GSW,13,9,158,39,58,.672,0,1,.000,39,57,.684,.672,6,9,.667,16,26,42,4,3,11,5,20,84
Rodney McGruder,2018,SG,26,MIA,4,0,16,1,4,.250,0,2,.000,1,2,.500,.250,0,0,,0,4,4,0,0,0,0,3,2
Khris Middleton,2018,SF,26,MIL,7,7,275,67,112,.598,25,41,.610,42,71,.592,.710,14,19,.737,1,35,36,22,6,5,16,30,173
C.J. Miles,2018,SF,30,TOR,10,1,227,32,71,.451,19,45,.422,13,26,.500,.585,13,16,.813,6,18,24,8,7,3,9,21,96
Darius Miller,2018,SF,27,NOP,9,0,162,14,34,.412,9,24,.375,5,10,.500,.544,6,6,1.000,2,18,20,11,5,0,6,10,43
Patty Mills,2018,PG,29,SAS,5,5,165,25,57,.439,13,35,.371,12,22,.545,.553,4,5,.800,2,8,10,13,3,1,9,15,67
Nikola MirotiÄ,2018,PF,26,NOP,9,9,320,49,102,.480,22,51,.431,27,51,.529,.588,15,19,.789,9,77,86,15,10,12,10,24,135
Donovan Mitchell,2018,SG,21,UTA,11,11,411,102,243,.420,25,80,.313,77,163,.472,.471,39,43,.907,9,56,65,46,16,4,32,35,268
Greg Monroe,2018,C,27,BOS,11,0,105,19,38,.500,0,0,,19,38,.500,.500,15,22,.682,14,21,35,5,2,2,14,9,53
E'Twaun Moore,2018,SG,28,NOP,9,9,284,41,88,.466,9,25,.360,32,63,.508,.517,11,16,.688,6,17,23,15,6,1,11,20,102
Marcus Morris,2018,PF,28,BOS,19,4,562,82,223,.368,30,72,.417,52,151,.344,.435,42,59,.712,20,83,103,21,7,5,19,60,236
Markieff Morris,2018,PF,28,WAS,6,6,181,24,49,.490,2,12,.167,22,37,.595,.510,9,10,.900,14,31,45,10,4,5,6,22,59
Shabazz Muhammad,2018,SG,25,MIL,4,0,29,9,20,.450,4,5,.800,5,15,.333,.550,3,5,.600,0,4,4,0,2,1,2,2,25
Dejounte Murray,2018,PG,21,SAS,5,5,96,14,31,.452,4,6,.667,10,25,.400,.516,7,9,.778,4,17,21,9,5,2,5,11,39
Abdel Nader,2018,SF,24,BOS,11,0,33,5,15,.333,0,4,.000,5,11,.455,.333,2,4,.500,1,2,3,3,1,1,2,2,12
Larry Nance Jr.,2018,C,25,CLE,20,0,307,41,60,.683,0,1,.000,41,59,.695,.683,14,31,.452,35,55,90,18,16,14,12,35,96
Shabazz Napier,2018,PG,26,POR,2,0,35,5,11,.455,0,4,.000,5,7,.714,.455,1,2,.500,0,2,2,3,3,0,6,1,11
Raul Neto,2018,PG,25,UTA,8,0,72,7,23,.304,2,7,.286,5,16,.313,.348,5,5,1.000,2,8,10,10,2,0,4,7,21
Lucas Nogueira,2018,C,25,TOR,5,0,24,0,1,.000,0,0,,0,1,.000,.000,1,2,.500,0,1,1,1,0,0,3,6,1
Jusuf NurkiÄ,2018,C,23,POR,4,4,94,19,39,.487,0,0,,19,39,.487,.487,9,11,.818,12,20,32,4,6,5,3,14,47
Royce O'Neale,2018,SF,24,UTA,11,5,259,28,56,.500,10,28,.357,18,28,.643,.589,12,19,.632,3,35,38,15,10,4,16,30,78
Semi Ojeleye,2018,PF,23,BOS,17,3,230,10,33,.303,6,22,.273,4,11,.364,.394,6,7,.857,4,24,28,2,3,0,2,21,32
Emeka Okafor,2018,C,35,NOP,1,0,4,0,1,.000,0,0,,0,1,.000,.000,0,0,,0,0,0,0,0,0,0,1,0
Victor Oladipo,2018,SG,25,IND,7,7,261,53,127,.417,23,57,.404,30,70,.429,.508,30,41,.732,3,55,58,42,17,3,24,11,159
Kelly Olynyk,2018,PF,26,MIA,5,0,146,21,44,.477,8,19,.421,13,25,.520,.568,14,20,.700,7,16,23,19,7,6,8,19,64
Chinanu Onuaku,2018,C,21,HOU,1,0,3,0,0,,0,0,,0,0,,,0,0,,1,0,1,1,1,0,0,1,0
Cedi Osman,2018,SF,22,CLE,14,0,62,6,18,.333,1,7,.143,5,11,.455,.361,1,4,.250,1,6,7,3,3,0,0,5,14
Kelly Oubre Jr.,2018,SF,22,WAS,6,1,148,18,48,.375,4,19,.211,14,29,.483,.417,16,18,.889,1,22,23,4,6,3,5,16,56
Zaza Pachulia,2018,C,33,GSW,7,0,26,4,7,.571,0,0,,4,7,.571,.571,9,12,.750,6,6,12,1,3,1,3,1,17
Jabari Parker,2018,PF,22,MIL,7,0,167,28,62,.452,6,19,.316,22,43,.512,.500,8,13,.615,8,35,43,10,7,4,6,15,70
Tony Parker,2018,PG,35,SAS,5,0,67,14,37,.378,0,5,.000,14,32,.438,.378,5,7,.714,0,4,4,6,2,0,4,2,33
Patrick Patterson,2018,PF,28,OKC,6,0,58,3,6,.500,2,4,.500,1,2,.500,.667,0,0,,1,10,11,3,1,0,3,8,8
Brandon Paul,2018,SG,26,SAS,1,0,3,0,0,,0,0,,0,0,,,0,0,,0,1,1,1,0,0,0,0,0
Chris Paul,2018,PG,32,HOU,15,15,517,118,257,.459,37,99,.374,81,158,.513,.531,44,53,.830,9,80,89,87,30,4,28,47,317
Jakob Poeltl,2018,C,22,TOR,9,0,140,17,31,.548,0,1,.000,17,30,.567,.548,15,19,.789,15,21,36,6,3,4,8,25,49
Otto Porter Jr.,2018,SF,24,WAS,5,5,158,20,41,.488,5,12,.417,15,29,.517,.549,5,8,.625,1,24,25,8,6,5,3,6,50
Norman Powell,2018,SG,24,TOR,6,0,40,4,14,.286,1,7,.143,3,7,.429,.321,3,4,.750,0,2,2,2,0,0,1,4,12
Zhou Qi,2018,C,22,HOU,3,0,6,1,1,1.000,0,0,,1,1,1.000,1.000,0,0,,0,1,1,0,0,0,0,0,2
J.J. Redick,2018,SG,33,PHI,10,10,342,60,135,.444,26,75,.347,34,60,.567,.541,36,42,.857,3,12,15,26,8,1,11,21,182
Josh Richardson,2018,SF,24,MIA,5,5,130,15,40,.375,6,19,.316,9,21,.429,.450,6,7,.857,4,11,15,14,11,5,5,17,42
Glenn Robinson III,2018,SF,24,IND,2,0,6,1,1,1.000,0,0,,1,1,1.000,1.000,0,0,,0,1,1,0,0,0,0,0,2
Rajon Rondo,2018,PG,31,NOP,9,9,302,38,92,.413,8,19,.421,30,73,.411,.457,9,14,.643,9,59,68,110,13,2,33,20,93
Derrick Rose,2018,PG,29,MIN,5,0,119,29,57,.509,7,10,.700,22,47,.468,.570,6,7,.857,1,8,9,13,2,0,8,9,71
Terry Rozier,2018,PG,23,BOS,19,19,696,108,266,.406,51,147,.347,57,119,.479,.502,46,56,.821,8,92,100,109,24,6,22,38,313
Ricky Rubio,2018,PG,27,UTA,6,6,181,28,79,.354,10,32,.313,18,47,.383,.418,18,23,.783,5,39,44,42,8,3,18,13,84
Domantas Sabonis,2018,C,21,IND,7,0,166,36,62,.581,1,7,.143,35,55,.636,.589,14,18,.778,14,18,32,5,1,2,7,22,87
Dario Å ariÄ,2018,PF,23,PHI,10,10,329,59,140,.421,20,52,.385,39,88,.443,.493,34,40,.850,32,41,73,35,10,4,15,28,172
TomÃ¡Å¡ SatoranskÃ½,2018,SG,26,WAS,6,0,60,2,13,.154,0,3,.000,2,10,.200,.154,3,4,.750,5,4,9,3,0,0,3,4,7
Mike Scott,2018,PF,29,WAS,6,0,126,26,41,.634,7,11,.636,19,30,.633,.720,6,6,1.000,6,15,21,4,2,1,5,10,65
Pascal Siakam,2018,PF,23,TOR,10,0,179,25,41,.610,3,4,.750,22,37,.595,.646,13,20,.650,9,27,36,8,1,6,7,27,66
Ben Simmons,2018,PG,21,PHI,10,10,369,61,125,.488,0,1,.000,61,124,.492,.488,41,58,.707,16,78,94,77,17,8,44,34,163
Marcus Smart,2018,SG,23,BOS,15,4,449,48,143,.336,15,68,.221,33,75,.440,.388,36,49,.735,14,42,56,80,26,10,36,44,147
J.R. Smith,2018,SG,32,CLE,22,21,706,65,187,.348,44,120,.367,21,67,.313,.465,17,22,.773,10,50,60,25,21,4,19,54,191
Jason Smith,2018,C,31,WAS,1,0,2,0,0,,0,0,,0,0,,,0,0,,0,0,0,0,0,0,0,0,0
Tony Snell,2018,SG,26,MIL,7,2,134,7,24,.292,5,21,.238,2,3,.667,.396,0,0,,1,12,13,4,3,4,3,10,19
Lance Stephenson,2018,SG,27,IND,7,0,149,30,65,.462,8,26,.308,22,39,.564,.523,5,9,.556,3,16,19,20,2,1,9,20,73
David Stockton,2018,PG,26,UTA,2,0,6,1,3,.333,0,1,.000,1,2,.500,.333,0,0,,0,1,1,0,0,0,0,1,2
Caleb Swanigan,2018,PF,20,POR,1,0,8,0,2,.000,0,1,.000,0,1,.000,.000,3,4,.750,0,2,2,1,0,0,1,1,3
Jayson Tatum,2018,SF,19,BOS,19,19,683,123,261,.471,23,71,.324,100,190,.526,.515,82,97,.845,10,73,83,52,23,10,41,50,351
Jeff Teague,2018,PG,29,MIN,5,5,153,23,51,.451,7,18,.389,16,33,.485,.520,12,17,.706,3,15,18,29,3,2,14,19,65
Jason Terry,2018,SG,40,MIL,3,0,44,2,5,.400,2,5,.400,0,0,,.600,0,0,,1,1,2,2,1,0,1,2,6
Klay Thompson,2018,SG,27,GSW,21,21,794,159,342,.465,67,157,.427,92,185,.497,.563,27,31,.871,11,75,86,38,16,6,31,48,412
Tristan Thompson,2018,C,26,CLE,19,11,416,49,83,.590,0,1,.000,49,82,.598,.590,20,27,.741,44,68,112,11,2,8,11,26,118
Karl-Anthony Towns,2018,C,22,MIN,5,5,170,28,60,.467,3,11,.273,25,49,.510,.492,17,23,.739,15,52,67,11,2,5,12,14,76
P.J. Tucker,2018,PF,32,HOU,17,17,569,52,108,.481,35,75,.467,17,33,.515,.644,12,18,.667,23,88,111,22,11,13,14,46,151
Evan Turner,2018,SF,29,POR,3,3,87,12,33,.364,2,7,.286,10,26,.385,.394,2,2,1.000,5,7,12,10,3,1,6,8,28
Myles Turner,2018,C,21,IND,7,7,196,33,54,.611,6,13,.462,27,41,.659,.667,15,19,.789,6,30,36,4,2,4,11,25,87
Ekpe Udoh,2018,C,30,UTA,6,0,21,1,1,1.000,0,0,,1,1,1.000,1.000,0,4,.000,1,2,3,0,0,2,1,2,2
Jonas ValanÄiÅ«nas,2018,C,25,TOR,10,9,244,58,107,.542,2,5,.400,56,102,.549,.551,28,34,.824,30,75,105,12,4,15,19,22,146
Fred VanVleet,2018,PG,23,TOR,6,1,114,13,39,.333,8,28,.286,5,11,.455,.436,7,8,.875,0,10,10,13,0,0,4,8,41
Dwyane Wade,2018,SG,36,MIA,5,0,127,31,70,.443,0,4,.000,31,66,.470,.443,21,26,.808,3,18,21,18,7,1,11,11,83
John Wall,2018,PG,27,WAS,6,6,234,56,127,.441,4,21,.190,52,106,.491,.457,40,47,.851,3,31,34,69,14,8,27,16,156
David West,2018,C,37,GSW,18,0,175,27,45,.600,1,2,.500,26,43,.605,.611,4,4,1.000,11,26,37,32,6,10,10,23,59
Russell Westbrook,2018,PG,29,OKC,6,6,235,64,161,.398,15,42,.357,49,119,.412,.444,33,40,.825,11,61,72,45,9,0,31,21,176
Derrick White,2018,PG,23,SAS,3,0,18,3,6,.500,1,2,.500,2,4,.500,.583,0,0,,0,0,0,1,1,2,0,0,7
Hassan Whiteside,2018,C,28,MIA,5,5,77,9,20,.450,0,0,,9,20,.450,.450,8,13,.615,10,20,30,1,0,6,12,16,26
Andrew Wiggins,2018,SF,22,MIN,5,5,164,30,68,.441,7,21,.333,23,47,.489,.493,12,20,.600,5,21,26,10,2,2,9,14,79
Justise Winslow,2018,PF,21,MIA,5,0,125,15,42,.357,7,19,.368,8,23,.348,.440,12,17,.706,7,26,33,13,4,4,8,17,49
Delon Wright,2018,PG,25,TOR,10,0,215,31,68,.456,9,21,.429,22,47,.468,.522,15,16,.938,3,19,22,23,15,9,9,10,86
Guerschon Yabusele,2018,PF,22,BOS,12,0,48,1,9,.111,0,6,.000,1,3,.333,.111,2,5,.400,3,8,11,3,2,0,0,9,4
Joe Young,2018,PG,25,IND,1,0,3,0,0,,0,0,,0,0,,,0,0,,0,0,0,0,0,0,0,1,0
Nick Young,2018,SG,32,GSW,20,2,205,16,53,.302,14,47,.298,2,6,.333,.434,6,8,.750,1,11,12,4,1,0,2,18,52
Thaddeus Young,2018,PF,29,IND,7,7,237,36,60,.600,2,7,.286,34,53,.642,.617,5,13,.385,22,32,54,10,12,6,7,22,79
Tyler Zeller,2018,C,28,MIL,7,3,66,4,5,.800,0,0,,4,5,.800,.800,3,4,.750,2,12,14,3,4,3,1,11,11
Ante Å½iÅ¾iÄ,2018,C,21,CLE,8,0,23,5,10,.500,0,0,,5,10,.500,.500,3,6,.500,1,5,6,1,0,1,2,2,13
Steven Adams,2019,C,25,OKC,5,5,159,28,42,.667,0,1,.000,28,41,.683,.667,3,8,.375,12,24,36,7,5,5,9,13,59
LaMarcus Aldridge,2019,C,33,SAS,7,7,244,55,121,.455,3,11,.273,52,110,.473,.467,27,33,.818,19,48,67,19,5,7,7,21,140
Grayson Allen,2019,SG,23,UTA,2,0,14,2,7,.286,0,3,.000,2,4,.500,.286,5,7,.714,0,1,1,0,0,0,0,0,9
Jarrett Allen,2019,C,20,BRK,5,5,110,19,32,.594,0,0,,19,32,.594,.594,17,20,.850,15,19,34,11,3,3,8,13,55
Al-Farouq Aminu,2019,PF,28,POR,16,16,399,38,109,.349,15,51,.294,23,58,.397,.417,27,36,.750,29,71,100,21,9,10,16,34,118
Giannis Antetokounmpo,2019,PF,24,MIL,15,15,514,129,262,.492,18,55,.327,111,207,.536,.527,107,168,.637,37,147,184,73,17,30,50,48,383
D.J. Augustin,2019,PG,31,ORL,5,5,141,20,41,.488,10,21,.476,10,20,.500,.610,14,16,.875,1,7,8,19,2,1,7,7,64
Will Barton,2019,SF,28,DEN,14,3,328,47,135,.348,15,55,.273,32,80,.400,.404,18,26,.692,15,52,67,24,4,9,13,19,127
Aron Baynes,2019,C,32,BOS,9,5,115,8,14,.571,2,6,.333,6,8,.750,.643,1,2,.500,6,19,25,3,3,3,5,20,19
Malik Beasley,2019,SG,22,DEN,14,0,281,36,93,.387,19,47,.404,17,46,.370,.489,22,31,.710,11,37,48,14,3,1,7,20,113
Marco Belinelli,2019,SG,32,SAS,7,0,131,14,38,.368,8,21,.381,6,17,.353,.474,5,6,.833,0,13,13,8,0,2,2,7,41
Jordan Bell,2019,C,24,GSW,15,2,106,17,31,.548,0,0,,17,31,.548,.548,7,10,.700,7,12,19,11,4,7,2,13,41
DÄvis BertÄns,2019,PF,26,SAS,5,0,79,5,15,.333,3,11,.273,2,4,.500,.433,3,5,.600,0,8,8,5,0,1,1,10,16
Patrick Beverley,2019,PG,30,LAC,6,6,195,20,47,.426,13,30,.433,7,17,.412,.564,6,8,.750,8,40,48,28,6,6,10,21,59
Khem Birch,2019,C,26,ORL,5,0,92,10,18,.556,0,0,,10,18,.556,.556,6,7,.857,9,22,31,4,1,5,6,8,26
Eric Bledsoe,2019,PG,29,MIL,15,15,423,76,185,.411,17,72,.236,59,113,.522,.457,36,51,.706,20,36,56,64,16,6,33,28,205
Bojan BogdanoviÄ,2019,SF,29,IND,4,4,148,25,63,.397,7,22,.318,18,41,.439,.452,15,17,.882,3,20,23,11,8,0,6,7,72
Andrew Bogut,2019,C,34,GSW,19,6,179,24,37,.649,0,0,,24,37,.649,.649,4,5,.800,23,51,74,21,5,6,10,38,52
Jonah Bolden,2019,PF,23,PHI,10,0,79,5,19,.263,4,16,.250,1,3,.333,.368,2,4,.500,4,10,14,3,2,1,9,12,16
Chris Boucher,2019,PF,26,TOR,2,0,4,2,5,.400,1,3,.333,1,2,.500,.500,0,1,.000,0,1,1,0,0,1,0,0,5
Malcolm Brogdon,2019,SG,26,MIL,7,2,198,35,78,.449,14,37,.378,21,41,.512,.538,7,11,.636,6,28,34,24,5,1,10,16,91
Bruce Brown,2019,SG,22,DET,4,2,57,5,14,.357,1,5,.200,4,9,.444,.393,2,2,1.000,1,7,8,2,2,1,2,8,13
Jaylen Brown,2019,SG,22,BOS,9,9,274,44,87,.506,14,40,.350,30,47,.638,.586,23,30,.767,6,46,52,10,6,2,15,30,125
Sterling Brown,2019,SG,23,MIL,11,5,162,15,38,.395,7,21,.333,8,17,.471,.487,8,11,.727,4,26,30,19,6,3,8,17,45
Deonte Burton,2019,SG,25,OKC,3,0,4,1,5,.200,0,2,.000,1,3,.333,.200,0,0,,1,1,2,0,0,0,0,0,2
Jimmy Butler,2019,SF,29,PHI,12,12,421,79,175,.451,12,45,.267,67,130,.515,.486,63,72,.875,22,51,73,62,17,7,22,20,233
JosÃ© CalderÃ³n,2019,PG,37,DET,3,0,10,0,0,,0,0,,0,0,,,0,0,,0,0,0,5,1,0,0,0,0
Clint Capela,2019,C,24,HOU,11,11,331,46,82,.561,0,0,,46,82,.561,.561,15,35,.429,41,72,113,16,3,12,16,26,107
DeMarre Carroll,2019,PF,32,BRK,5,3,119,9,38,.237,7,24,.292,2,14,.143,.329,8,8,1.000,6,14,20,2,4,0,3,8,33
Michael Carter-Williams,2019,PG,27,ORL,5,0,92,12,31,.387,2,8,.250,10,23,.435,.419,7,8,.875,2,18,20,12,3,0,8,12,33
Wilson Chandler,2019,SF,31,LAC,4,0,52,5,16,.313,1,10,.100,4,6,.667,.344,4,4,1.000,0,6,6,2,2,0,3,7,15
Gary Clark,2019,PF,24,HOU,2,0,4,0,0,,0,0,,0,0,,,0,0,,0,1,1,0,0,0,0,0,0
Zach Collins,2019,C,21,POR,16,0,275,41,81,.506,7,21,.333,34,60,.567,.549,20,25,.800,16,41,57,14,7,22,20,54,109
Darren Collison,2019,PG,31,IND,4,4,117,19,45,.422,4,11,.364,15,34,.441,.467,6,6,1.000,4,8,12,16,2,0,10,11,48
Pat Connaughton,2019,SG,26,MIL,15,0,324,37,77,.481,15,42,.357,22,35,.629,.578,4,8,.500,10,83,93,21,6,13,8,14,93
Quinn Cook,2019,PG,25,GSW,17,0,193,28,70,.400,11,34,.324,17,36,.472,.479,4,4,1.000,2,16,18,12,3,1,6,13,71
DeMarcus Cousins,2019,C,28,GSW,8,5,133,21,53,.396,3,12,.250,18,41,.439,.425,16,25,.640,9,30,39,19,5,6,19,24,61
Torrey Craig,2019,SF,28,DEN,14,11,330,33,69,.478,17,36,.472,16,33,.485,.601,9,16,.563,21,51,72,12,7,5,6,38,92
Jae Crowder,2019,SF,28,UTA,5,3,130,17,46,.370,9,30,.300,8,16,.500,.467,14,19,.737,4,25,29,4,5,0,1,7,57
Dante Cunningham,2019,PF,31,SAS,5,0,13,2,3,.667,2,2,1.000,0,1,.000,1.000,0,0,,2,4,6,0,0,0,0,0,6
Seth Curry,2019,SG,28,POR,16,0,326,30,82,.366,21,52,.404,9,30,.300,.494,9,11,.818,5,20,25,13,12,4,7,27,90
Stephen Curry,2019,PG,30,GSW,22,22,846,190,431,.441,92,244,.377,98,187,.524,.548,148,157,.943,17,115,132,126,24,4,66,68,620
Ed Davis,2019,C,29,BRK,3,0,41,7,10,.700,0,0,,7,10,.700,.700,2,2,1.000,4,15,19,2,0,1,0,9,16
DeMar DeRozan,2019,SG,29,SAS,7,7,251,58,119,.487,0,1,.000,58,118,.492,.487,38,44,.864,10,37,47,32,8,1,12,16,154
Spencer Dinwiddie,2019,PG,25,BRK,5,0,131,27,62,.435,9,24,.375,18,38,.474,.508,10,14,.714,4,9,13,8,2,0,8,10,73
Andre Drummond,2019,C,25,DET,4,4,127,24,54,.444,0,1,.000,24,53,.453,.444,9,21,.429,20,32,52,9,6,5,11,17,57
Jared Dudley,2019,PF,33,BRK,4,2,82,3,11,.273,2,9,.222,1,2,.500,.364,4,4,1.000,0,2,2,11,3,1,4,10,12
Kevin Durant,2019,SF,30,GSW,12,12,442,125,243,.514,35,80,.438,90,163,.552,.586,102,113,.903,1,58,59,54,13,12,43,38,387
Wayne Ellington,2019,SG,31,DET,4,4,131,11,35,.314,7,22,.318,4,13,.308,.414,2,2,1.000,3,12,15,5,3,0,2,4,31
Joel Embiid,2019,C,24,PHI,11,11,334,68,159,.428,12,39,.308,56,120,.467,.465,74,90,.822,21,94,115,37,8,25,40,34,222
James Ennis III,2019,SF,28,PHI,11,0,232,31,64,.484,9,32,.281,22,32,.688,.555,12,19,.632,16,26,42,12,4,3,10,31,83
Jacob Evans,2019,SG,21,GSW,7,0,18,2,5,.400,1,2,.500,1,3,.333,.500,0,0,,0,1,1,1,0,0,2,1,5
Tyreke Evans,2019,SG,29,IND,4,0,84,21,48,.438,11,20,.550,10,28,.357,.552,8,14,.571,0,17,17,3,2,1,6,8,61
Kenneth Faried,2019,C,29,HOU,6,0,56,9,13,.692,1,1,1.000,8,12,.667,.731,5,6,.833,3,18,21,2,2,0,0,6,24
Derrick Favors,2019,C,27,UTA,5,2,103,23,36,.639,0,3,.000,23,33,.697,.639,13,19,.684,15,22,37,4,4,9,5,12,59
Raymond Felton,2019,PG,34,OKC,5,0,57,4,13,.308,2,8,.250,2,5,.400,.385,1,2,.500,0,3,3,3,4,1,2,7,11
Terrance Ferguson,2019,SG,20,OKC,5,5,128,9,25,.360,7,18,.389,2,7,.286,.500,0,0,,2,10,12,6,2,0,5,19,25
Bryn Forbes,2019,SG,25,SAS,7,7,212,27,56,.482,15,31,.484,12,25,.480,.616,6,9,.667,1,24,25,7,1,1,3,14,75
Evan Fournier,2019,SG,26,ORL,5,5,175,24,69,.348,8,34,.235,16,35,.457,.406,6,8,.750,3,13,16,10,7,0,12,14,62
Melvin Frazier,2019,SG,22,ORL,3,0,15,2,5,.400,0,0,,2,5,.400,.400,1,2,.500,1,3,4,0,1,0,0,0,5
Tim Frazier,2019,PG,28,MIL,11,0,40,8,13,.615,3,6,.500,5,7,.714,.731,2,2,1.000,0,9,9,10,1,0,3,5,21
Enes Freedom,2019,C,26,POR,16,14,461,75,146,.514,1,4,.250,74,142,.521,.517,31,41,.756,53,102,155,19,11,9,26,36,182
Danilo Gallinari,2019,SF,30,LAC,6,6,201,39,111,.351,13,43,.302,26,68,.382,.410,28,33,.848,9,28,37,16,8,1,11,14,119
Langston Galloway,2019,SG,27,DET,4,0,110,11,34,.324,9,25,.360,2,9,.222,.456,0,0,,2,13,15,4,2,4,2,10,31
Marc Gasol,2019,C,34,TOR,24,24,735,76,180,.422,34,89,.382,42,91,.462,.517,40,46,.870,16,137,153,73,21,26,21,84,226
Rudy Gay,2019,PF,32,SAS,7,0,179,28,70,.400,8,19,.421,20,51,.392,.457,14,17,.824,13,37,50,12,3,5,10,13,78
Paul George,2019,SF,28,OKC,5,5,204,44,101,.436,15,47,.319,29,54,.537,.510,40,49,.816,6,37,43,18,7,1,20,21,143
Shai Gilgeous-Alexander,2019,PG,20,LAC,6,6,173,28,60,.467,9,18,.500,19,42,.452,.542,17,20,.850,4,12,16,19,6,5,5,17,82
Rudy Gobert,2019,C,26,UTA,5,5,152,19,32,.594,0,0,,19,32,.594,.594,18,23,.783,23,28,51,7,3,13,9,16,56
Aaron Gordon,2019,PF,23,ORL,5,5,164,29,62,.468,8,20,.400,21,42,.500,.532,10,19,.526,11,25,36,18,6,1,13,16,76
Eric Gordon,2019,SG,30,HOU,11,11,410,67,150,.447,38,95,.400,29,55,.527,.573,24,28,.857,5,22,27,14,7,11,27,22,196
Treveon Graham,2019,SG,25,BRK,5,0,79,2,10,.200,0,7,.000,2,3,.667,.200,3,6,.500,3,8,11,3,2,1,3,10,7
Jerami Grant,2019,PF,24,OKC,5,5,176,20,40,.500,9,20,.450,11,20,.550,.613,9,13,.692,6,22,28,4,3,10,4,13,58
Jerian Grant,2019,PG,26,ORL,3,0,14,2,10,.200,0,7,.000,2,3,.667,.200,1,1,1.000,0,4,4,3,0,0,1,1,5
Danny Green,2019,SG,31,TOR,24,24,684,53,155,.342,39,119,.328,14,36,.389,.468,21,23,.913,17,70,87,26,31,11,26,60,166
Draymond Green,2019,PF,28,GSW,22,22,851,114,229,.498,13,57,.228,101,172,.587,.526,51,71,.718,41,182,223,187,32,33,83,85,292
Gerald Green,2019,SG,33,HOU,11,0,97,12,40,.300,10,29,.345,2,11,.182,.425,5,5,1.000,0,12,12,1,3,3,3,12,39
JaMychal Green,2019,PF,28,LAC,6,3,141,23,43,.535,12,23,.522,11,20,.550,.674,8,10,.800,6,26,32,5,4,0,11,22,66
Blake Griffin,2019,PF,29,DET,2,2,58,18,39,.462,6,13,.462,12,26,.462,.538,7,7,1.000,4,8,12,12,2,0,6,9,49
James Harden,2019,PG,29,HOU,11,11,424,109,264,.413,48,137,.350,61,127,.480,.504,82,98,.837,9,67,76,73,24,10,51,41,348
Maurice Harkless,2019,SF,25,POR,16,16,388,52,109,.477,7,28,.250,45,81,.556,.509,23,36,.639,29,49,78,23,18,16,17,56,134
Montrezl Harrell,2019,C,25,LAC,6,0,158,46,63,.730,0,1,.000,46,62,.742,.730,18,26,.692,12,21,33,13,3,4,8,19,110
Gary Harris,2019,SG,24,DEN,14,14,517,73,158,.462,20,57,.351,53,101,.525,.525,33,38,.868,9,49,58,32,12,8,11,38,199
Joe Harris,2019,SG,27,BRK,5,5,149,16,43,.372,4,21,.190,12,22,.545,.419,8,8,1.000,6,15,21,3,3,0,9,12,44
Tobias Harris,2019,PF,26,PHI,12,12,443,71,167,.425,22,63,.349,49,104,.471,.491,22,26,.846,12,97,109,48,13,6,19,30,186
Isaiah Hartenstein,2019,PF,20,HOU,2,0,2,2,2,1.000,0,0,,2,2,1.000,1.000,0,0,,1,0,1,0,0,0,0,1,4
Gordon Hayward,2019,PF,28,BOS,9,0,267,29,70,.414,9,24,.375,20,46,.435,.479,19,19,1.000,3,33,36,22,6,3,15,16,86
Juancho HernangÃ³mez,2019,PF,23,DEN,5,0,15,1,3,.333,1,2,.500,0,1,.000,.500,0,0,,0,3,3,0,0,0,1,2,3
NenÃª,2019,C,36,HOU,7,0,53,10,10,1.000,0,0,,10,10,1.000,1.000,7,9,.778,9,5,14,3,3,2,3,7,27
George Hill,2019,PG,32,MIL,15,0,395,63,118,.534,20,48,.417,43,70,.614,.619,27,33,.818,15,38,53,42,13,4,6,34,173
Aaron Holiday,2019,PG,22,IND,3,0,13,2,5,.400,1,2,.500,1,3,.333,.500,0,0,,0,0,0,0,0,0,1,3,5
Rondae Hollis-Jefferson,2019,SF,24,BRK,4,0,62,16,33,.485,1,1,1.000,15,32,.469,.500,20,25,.800,3,9,12,6,1,5,3,7,53
Rodney Hood,2019,SG,26,POR,16,0,373,52,111,.468,18,51,.353,34,60,.567,.550,36,44,.818,9,27,36,14,6,3,7,28,158
Al Horford,2019,C,32,BOS,9,9,310,46,110,.418,18,44,.409,28,66,.424,.500,15,18,.833,13,68,81,40,4,7,19,21,125
Danuel House Jr.,2019,SF,25,HOU,7,0,141,11,37,.297,8,31,.258,3,6,.500,.405,4,8,.500,2,20,22,1,3,2,4,11,34
Serge Ibaka,2019,C,29,TOR,24,0,500,92,193,.477,9,38,.237,83,155,.535,.500,32,42,.762,35,108,143,22,11,23,25,79,225
Andre Iguodala,2019,SF,35,GSW,21,15,629,82,166,.494,28,80,.350,54,86,.628,.578,14,37,.378,27,64,91,83,24,23,21,43,206
Ersan Ä°lyasova,2019,PF,31,MIL,15,0,272,35,81,.432,12,40,.300,23,41,.561,.506,20,25,.800,19,51,70,21,10,6,6,40,102
Joe Ingles,2019,PF,31,UTA,5,5,151,12,37,.324,8,29,.276,4,8,.500,.432,0,0,,3,21,24,25,11,0,8,14,32
Kyrie Irving,2019,PG,26,BOS,9,9,330,69,179,.385,18,58,.310,51,121,.421,.436,36,40,.900,5,35,40,63,12,4,28,26,192
Jonathan Isaac,2019,PF,21,ORL,5,5,137,11,40,.275,4,20,.200,7,20,.350,.325,7,8,.875,10,21,31,2,2,5,5,9,33
Wes Iwundu,2019,SF,24,ORL,5,0,60,6,18,.333,3,9,.333,3,9,.333,.417,9,9,1.000,0,7,7,4,3,0,2,4,24
Reggie Jackson,2019,PG,28,DET,4,4,108,28,65,.431,9,21,.429,19,44,.432,.500,6,7,.857,5,8,13,28,3,0,5,12,71
Jonas Jerebko,2019,PF,31,GSW,16,0,121,12,42,.286,5,19,.263,7,23,.304,.345,5,6,.833,15,19,34,12,1,2,2,9,34
Amir Johnson,2019,C,31,PHI,4,0,20,4,4,1.000,0,0,,4,4,1.000,1.000,0,0,,3,2,5,2,1,0,1,3,8
Nikola JokiÄ,2019,C,23,DEN,14,14,557,132,261,.506,22,56,.393,110,205,.537,.548,66,78,.846,54,128,182,118,16,13,36,54,352
Damian Jones,2019,C,23,GSW,4,1,8,1,1,1.000,0,0,,1,1,1.000,1.000,1,2,.500,0,2,2,0,0,0,1,3,3
Cory Joseph,2019,PG,27,IND,4,0,85,12,24,.500,4,9,.444,8,15,.533,.583,2,2,1.000,1,6,7,4,4,0,0,7,30
Luke Kennard,2019,SG,22,DET,4,2,133,23,47,.489,9,15,.600,14,32,.438,.585,5,6,.833,0,16,16,7,3,1,3,6,60
Furkan Korkmaz,2019,SG,21,PHI,4,0,36,6,18,.333,3,8,.375,3,10,.300,.417,4,5,.800,0,6,6,5,0,1,1,5,19
Kyle Korver,2019,SG,37,UTA,4,0,30,3,8,.375,2,6,.333,1,2,.500,.500,2,3,.667,1,4,5,0,0,0,1,6,10
Rodions Kurucs,2019,SF,20,BRK,4,3,68,8,20,.400,2,8,.250,6,12,.500,.450,7,9,.778,6,14,20,3,2,0,2,10,25
Skal LabissiÃ¨re,2019,PF,22,POR,3,0,11,1,4,.250,0,2,.000,1,2,.500,.250,0,1,.000,0,0,0,0,0,0,0,1,2
Jake Layman,2019,SF,24,POR,6,0,20,1,7,.143,0,5,.000,1,2,.500,.143,3,4,.750,1,3,4,0,0,0,0,3,5
T.J. Leaf,2019,PF,21,IND,1,0,10,0,3,.000,0,1,.000,0,2,.000,.000,2,2,1.000,1,2,3,0,0,0,0,0,2
Kawhi Leonard,2019,SF,27,TOR,24,24,939,243,496,.490,55,145,.379,188,351,.536,.545,191,216,.884,54,164,218,94,40,17,74,56,732
Meyers Leonard,2019,C,26,POR,11,2,170,34,65,.523,14,33,.424,20,32,.625,.631,3,9,.333,6,34,40,12,2,1,4,27,85
Jon Leuer,2019,PF,29,DET,1,0,5,1,2,.500,0,0,,1,2,.500,.500,0,1,.000,0,0,0,0,0,0,0,1,2
Caris LeVert,2019,SF,24,BRK,5,2,144,36,73,.493,12,26,.462,24,47,.511,.575,21,29,.724,6,17,23,15,5,2,10,8,105
Damian Lillard,2019,PG,28,POR,16,16,650,138,330,.418,59,158,.373,79,172,.459,.508,95,114,.833,8,68,76,106,27,5,60,40,430
Jeremy Lin,2019,PG,30,TOR,8,0,27,2,9,.222,1,2,.500,1,7,.143,.278,4,4,1.000,0,3,3,4,1,0,5,2,9
Shaun Livingston,2019,PG,33,GSW,22,2,322,34,75,.453,0,2,.000,34,73,.466,.453,21,25,.840,11,20,31,31,10,4,8,35,89
Kevon Looney,2019,C,22,GSW,21,1,432,64,93,.688,0,0,,64,93,.688,.688,21,29,.724,41,53,94,20,12,11,13,50,149
Brook Lopez,2019,C,30,MIL,15,15,438,61,134,.455,22,75,.293,39,59,.661,.537,24,29,.828,12,70,82,21,6,28,10,46,168
Kyle Lowry,2019,PG,32,TOR,24,24,901,122,278,.439,52,145,.359,70,133,.526,.532,65,81,.802,21,96,117,159,31,7,53,96,361
Trey Lyles,2019,PF,23,DEN,3,0,8,0,3,.000,0,1,.000,0,2,.000,.000,0,0,,1,0,1,2,0,0,0,1,0
Thon Maker,2019,PF,21,DET,4,2,69,7,26,.269,0,12,.000,7,14,.500,.269,8,9,.889,4,5,9,4,0,4,3,14,22
Boban MarjanoviÄ,2019,C,30,PHI,11,0,105,24,40,.600,0,3,.000,24,37,.649,.600,16,19,.842,13,23,36,11,2,3,14,18,64
Jarell Martin,2019,PF,24,ORL,3,0,18,4,9,.444,2,7,.286,2,2,1.000,.556,0,2,.000,1,1,2,1,0,1,0,1,10
Wesley Matthews,2019,SG,32,IND,4,4,119,9,30,.300,7,21,.333,2,9,.222,.417,3,3,1.000,0,10,10,8,3,1,8,6,28
Patrick McCaw,2019,SG,23,TOR,11,0,48,1,5,.200,1,3,.333,0,2,.000,.300,2,2,1.000,2,1,3,4,2,0,1,4,5
CJ McCollum,2019,SG,27,POR,16,16,635,154,350,.440,46,117,.393,108,233,.464,.506,41,56,.732,14,66,80,59,13,10,30,34,395
T.J. McConnell,2019,PG,26,PHI,9,0,75,12,27,.444,0,0,,12,27,.444,.444,0,0,,1,5,6,11,2,1,1,4,24
Doug McDermott,2019,SF,27,IND,3,0,29,2,10,.200,0,7,.000,2,3,.667,.200,2,4,.500,3,2,5,4,0,1,0,2,6
Alfonzo McKinnie,2019,SF,26,GSW,22,1,235,26,59,.441,10,32,.313,16,27,.593,.525,4,10,.400,17,33,50,4,2,1,6,32,66
Jodie Meeks,2019,SG,31,TOR,14,0,66,9,29,.310,2,13,.154,7,16,.438,.345,2,3,.667,0,9,9,1,4,1,3,7,22
Khris Middleton,2019,SF,27,MIL,15,15,515,84,201,.418,40,92,.435,44,109,.404,.517,46,52,.885,9,86,95,66,9,0,29,44,254
Malcolm Miller,2019,SF,25,TOR,10,0,28,2,8,.250,1,6,.167,1,2,.500,.313,3,4,.750,0,5,5,1,0,1,1,3,8
Patty Mills,2019,PG,30,SAS,7,0,152,14,43,.326,3,22,.136,11,21,.524,.360,6,10,.600,1,14,15,25,7,1,3,9,37
Paul Millsap,2019,PF,33,DEN,14,14,469,73,157,.465,12,38,.316,61,119,.513,.503,47,61,.770,24,70,94,11,12,15,18,48,205
Nikola MirotiÄ,2019,PF,27,MIL,14,8,298,44,117,.376,22,76,.289,22,41,.537,.470,23,28,.821,17,43,60,10,10,3,14,25,133
Donovan Mitchell,2019,SG,22,UTA,5,5,193,36,112,.321,11,43,.256,25,69,.362,.371,24,33,.727,7,18,25,16,8,1,21,15,107
Greg Monroe,2019,C,28,PHI,10,1,90,16,40,.400,1,4,.250,15,36,.417,.413,7,9,.778,14,17,31,4,5,4,4,11,40
Eric Moreland,2019,PF,27,TOR,8,0,28,1,2,.500,0,0,,1,2,.500,.500,0,0,,1,12,13,3,0,0,0,5,2
Marcus Morris,2019,PF,29,BOS,9,4,254,41,79,.519,18,40,.450,23,39,.590,.633,23,31,.742,12,61,73,11,1,5,7,22,123
Markieff Morris,2019,PF,29,OKC,5,0,59,5,16,.313,2,7,.286,3,9,.333,.375,7,9,.778,4,9,13,5,1,3,2,9,19
Monte Morris,2019,PG,23,DEN,14,0,224,33,86,.384,0,13,.000,33,73,.452,.384,9,13,.692,3,16,19,36,5,1,6,15,75
Donatas MotiejÅ«nas,2019,PF,28,SAS,5,0,19,6,10,.600,0,1,.000,6,9,.667,.600,1,2,.500,3,4,7,2,0,0,0,1,13
Jamal Murray,2019,PG,21,DEN,14,14,508,107,252,.425,28,83,.337,79,169,.467,.480,56,62,.903,19,42,61,66,14,2,22,24,298
DÅ¾anan Musa,2019,SG,19,BRK,2,0,15,2,3,.667,0,1,.000,2,2,1.000,.667,0,0,,0,0,0,0,2,0,3,4,4
Abdel Nader,2019,SF,25,OKC,3,0,5,1,2,.500,0,0,,1,2,.500,.500,0,0,,0,0,0,0,0,1,0,0,2
Shabazz Napier,2019,PG,27,BRK,3,0,28,7,11,.636,3,5,.600,4,6,.667,.773,7,8,.875,2,5,7,11,1,0,0,1,24
Raul Neto,2019,PG,26,UTA,3,0,20,1,6,.167,0,1,.000,1,5,.200,.167,0,0,,0,3,3,1,0,0,0,2,2
Georges Niang,2019,PF,25,UTA,5,0,55,9,22,.409,4,13,.308,5,9,.556,.500,0,0,,0,14,14,5,1,1,2,5,22
Nerlens Noel,2019,C,24,OKC,5,0,60,12,20,.600,0,0,,12,20,.600,.600,0,2,.000,11,8,19,0,2,3,5,9,24
Royce O'Neale,2019,SF,25,UTA,5,0,137,21,45,.467,8,23,.348,13,22,.591,.556,3,4,.750,2,21,23,8,2,2,10,15,53
Kyle O'Quinn,2019,C,28,IND,1,0,2,0,0,,0,0,,0,0,,,0,0,,0,0,0,0,0,0,1,0,0
Semi Ojeleye,2019,PF,24,BOS,6,0,34,4,9,.444,3,5,.600,1,4,.250,.611,2,2,1.000,1,1,2,2,0,0,1,5,13
Zaza Pachulia,2019,C,34,DET,2,0,22,2,6,.333,0,0,,2,6,.333,.333,1,2,.500,1,8,9,0,0,0,1,3,5
Chris Paul,2019,PG,33,HOU,11,11,397,66,148,.446,17,63,.270,49,85,.576,.503,38,45,.844,14,56,70,60,24,7,37,36,187
Theo Pinson,2019,SG,23,BRK,3,0,22,3,8,.375,3,7,.429,0,1,.000,.563,0,0,,0,3,3,3,2,0,1,0,9
Mason Plumlee,2019,C,28,DEN,14,0,218,24,47,.511,0,1,.000,24,46,.522,.511,16,28,.571,26,36,62,21,7,10,8,39,64
Jakob Poeltl,2019,C,23,SAS,7,7,177,23,36,.639,0,1,.000,23,35,.657,.639,5,9,.556,25,29,54,12,2,5,3,26,51
Quincy Pondexter,2019,SF,30,SAS,5,0,12,0,2,.000,0,1,.000,0,1,.000,.000,0,0,,0,1,1,2,1,0,0,2,0
Norman Powell,2019,SG,25,TOR,23,0,366,56,126,.444,24,62,.387,32,64,.500,.540,14,19,.737,5,46,51,26,9,0,12,31,150
J.J. Redick,2019,SG,34,PHI,12,12,376,54,124,.435,36,87,.414,18,37,.486,.581,17,20,.850,1,16,17,19,1,3,22,32,161
Austin Rivers,2019,SG,26,HOU,10,0,215,27,62,.435,16,35,.457,11,27,.407,.565,4,6,.667,2,19,21,10,5,1,8,31,74
Glenn Robinson III,2019,SF,25,DET,3,0,36,4,15,.267,1,8,.125,3,7,.429,.300,4,4,1.000,2,5,7,2,2,0,1,5,13
Jerome Robinson,2019,SG,21,LAC,5,0,46,5,14,.357,3,6,.500,2,8,.250,.464,5,5,1.000,2,4,6,7,2,0,1,4,18
Terrence Ross,2019,SG,27,ORL,5,0,146,20,54,.370,12,35,.343,8,19,.421,.481,14,17,.824,1,17,18,7,6,2,10,10,66
Terry Rozier,2019,PG,24,BOS,9,0,162,19,59,.322,8,34,.235,11,25,.440,.390,12,16,.750,4,35,39,17,4,2,10,15,58
Ricky Rubio,2019,PG,28,UTA,5,5,168,28,66,.424,4,20,.200,24,46,.522,.455,17,20,.850,3,13,16,43,12,1,15,14,77
D'Angelo Russell,2019,PG,22,BRK,5,5,148,37,103,.359,12,37,.324,25,66,.379,.417,11,13,.846,2,16,18,18,7,1,14,12,97
Domantas Sabonis,2019,C,22,IND,4,0,96,12,29,.414,1,4,.250,11,25,.440,.431,9,14,.643,7,22,29,16,3,1,5,12,34
Dennis SchrÃ¶der,2019,PG,25,OKC,5,0,151,25,55,.455,6,20,.300,19,35,.543,.509,13,18,.722,2,14,16,17,4,0,6,11,69
Mike Scott,2019,PF,30,PHI,10,0,193,21,47,.447,12,34,.353,9,13,.692,.574,2,2,1.000,4,30,34,5,3,0,7,22,56
Thabo Sefolosha,2019,SF,34,UTA,4,0,42,2,14,.143,1,8,.125,1,6,.167,.179,0,0,,1,7,8,2,0,0,1,3,5
Landry Shamet,2019,SG,21,LAC,6,6,174,13,38,.342,10,31,.323,3,7,.429,.474,10,10,1.000,1,11,12,10,6,0,7,15,46
Iman Shumpert,2019,SG,28,HOU,8,0,109,10,26,.385,8,22,.364,2,4,.500,.538,1,4,.250,1,11,12,2,1,0,3,10,29
Pascal Siakam,2019,PF,24,TOR,24,24,891,180,383,.470,29,104,.279,151,279,.541,.508,66,87,.759,40,131,171,66,25,17,33,67,455
Ben Simmons,2019,PG,22,PHI,12,12,421,72,116,.621,0,0,,72,116,.621,.621,23,40,.575,24,61,85,72,15,12,32,45,167
Jonathon Simmons,2019,SF,29,PHI,7,0,52,10,30,.333,2,10,.200,8,20,.400,.367,3,4,.750,2,7,9,2,1,0,6,2,25
Anfernee Simons,2019,SG,19,POR,5,0,12,0,7,.000,0,2,.000,0,5,.000,.000,4,5,.800,0,0,0,0,1,0,0,2,4
Marcus Smart,2019,SG,24,BOS,2,0,32,1,11,.091,1,11,.091,0,0,,.136,4,6,.667,4,0,4,4,3,0,3,3,7
Ish Smith,2019,PG,30,DET,4,0,81,10,38,.263,1,7,.143,9,31,.290,.276,3,4,.750,1,10,11,14,3,1,4,8,24
Zhaire Smith,2019,SG,19,PHI,2,0,5,0,0,,0,0,,0,0,,,0,0,,0,0,0,0,1,0,0,0,0
Tony Snell,2019,SF,27,MIL,9,0,28,2,6,.333,1,2,.500,1,4,.250,.417,0,0,,1,1,2,0,1,1,0,3,5
Edmond Sumner,2019,PG,23,IND,1,0,2,0,0,,0,0,,0,0,,,0,0,,0,2,2,0,0,0,0,0,0
Jayson Tatum,2019,SF,20,BOS,9,9,295,49,112,.438,10,31,.323,39,81,.481,.482,29,39,.744,7,53,60,17,10,7,18,21,137
Garrett Temple,2019,SG,32,LAC,6,0,63,3,11,.273,1,7,.143,2,4,.500,.318,7,10,.700,1,6,7,2,3,1,2,8,14
Daniel Theis,2019,C,26,BOS,7,0,42,5,14,.357,0,2,.000,5,12,.417,.357,2,2,1.000,4,6,10,0,1,1,1,4,12
Khyri Thomas,2019,SG,22,DET,3,0,15,6,12,.500,1,4,.250,5,8,.625,.542,1,1,1.000,0,2,2,0,2,0,0,0,14
Klay Thompson,2019,SG,28,GSW,21,21,818,164,360,.456,70,158,.443,94,202,.465,.553,37,41,.902,12,74,86,44,28,15,38,59,435
Sindarius Thornwell,2019,SG,24,LAC,4,0,12,2,6,.333,1,3,.333,1,3,.333,.417,0,0,,0,4,4,0,1,0,0,2,5
P.J. Tucker,2019,PF,33,HOU,11,11,426,40,88,.455,26,57,.456,14,31,.452,.602,19,23,.826,19,63,82,19,19,8,8,35,125
Evan Turner,2019,PG,30,POR,16,0,245,15,46,.326,1,1,1.000,14,45,.311,.337,12,15,.800,13,60,73,35,3,3,13,22,43
Myles Turner,2019,C,22,IND,4,4,126,14,35,.400,3,14,.214,11,21,.524,.443,8,13,.615,4,21,25,6,0,7,3,14,39
Ekpe Udoh,2019,C,31,UTA,2,0,6,0,1,.000,0,0,,0,1,.000,.000,0,0,,0,0,0,0,0,0,0,0,0
Jarred Vanderbilt,2019,PF,19,DEN,3,0,5,0,0,,0,0,,0,0,,,0,0,,0,1,1,0,0,1,0,0,0
Fred VanVleet,2019,PG,24,TOR,24,0,592,65,166,.392,38,98,.388,27,68,.397,.506,24,31,.774,8,34,42,62,18,6,21,49,192
Nikola VuÄeviÄ,2019,C,28,ORL,5,5,147,21,58,.362,3,13,.231,18,45,.400,.388,11,14,.786,9,31,40,15,2,5,13,12,56
Lonnie Walker IV,2019,SG,20,SAS,6,0,21,3,8,.375,0,1,.000,3,7,.429,.375,0,0,,0,2,2,3,0,0,0,0,6
Tyrone Wallace,2019,PG,24,LAC,2,0,11,1,4,.250,0,0,,1,4,.250,.250,2,3,.667,0,1,1,3,0,0,1,2,4
Brad Wanamaker,2019,PG,29,BOS,4,0,17,3,7,.429,1,1,1.000,2,6,.333,.500,3,4,.750,0,1,1,3,1,0,2,0,10
Russell Westbrook,2019,PG,30,OKC,5,5,197,40,111,.360,11,34,.324,29,77,.377,.410,23,26,.885,7,37,44,53,5,3,23,19,114
Derrick White,2019,PG,24,SAS,7,7,191,41,75,.547,5,17,.294,36,58,.621,.580,19,26,.731,1,20,21,21,5,5,15,17,106
Lou Williams,2019,SG,32,LAC,6,0,176,45,104,.433,6,18,.333,39,86,.453,.462,34,41,.829,6,11,17,46,5,1,18,14,130
Robert Williams,2019,C,21,BOS,3,0,13,1,2,.500,0,0,,1,2,.500,.500,2,2,1.000,1,6,7,0,0,0,0,1,4
D.J. Wilson,2019,PF,22,MIL,8,0,43,8,16,.500,1,5,.200,7,11,.636,.531,2,2,1.000,1,9,10,4,0,1,7,7,19
Guerschon Yabusele,2019,PF,23,BOS,4,0,14,2,4,.500,0,1,.000,2,3,.667,.500,4,7,.571,1,1,2,1,0,1,1,3,8
Thaddeus Young,2019,PF,30,IND,4,4,130,18,42,.429,2,8,.250,16,34,.471,.452,4,7,.571,9,19,28,15,11,3,5,10,42
Ivica Zubac,2019,C,21,LAC,4,3,39,9,18,.500,0,0,,9,18,.500,.500,2,3,.667,11,11,22,1,2,2,4,5,20
Jaylen Adams,2020,PG,23,POR,3,0,21,3,9,.333,0,4,.000,3,5,.600,.333,0,0,,1,2,3,2,1,0,0,1,6
Steven Adams,2020,C,26,OKC,7,7,210,31,52,.596,0,1,.000,31,51,.608,.596,9,20,.450,34,47,81,9,4,2,16,10,71
Bam Adebayo,2020,PF,22,MIA,19,19,687,124,220,.564,0,1,.000,124,219,.566,.564,90,115,.783,47,149,196,84,19,16,47,58,338
Jarrett Allen,2020,C,21,BRK,4,4,132,14,24,.583,0,0,,14,24,.583,.583,13,16,.813,17,42,59,9,2,7,11,7,41
Justin Anderson,2020,SG,26,BRK,3,0,28,5,12,.417,5,11,.455,0,1,.000,.625,4,4,1.000,0,8,8,3,0,1,2,2,19
Giannis Antetokounmpo,2020,PF,25,MIL,9,9,277,90,161,.559,13,40,.325,77,121,.636,.599,47,81,.580,27,97,124,51,6,8,30,31,240
Carmelo Anthony,2020,PF,35,POR,5,5,176,28,68,.412,8,19,.421,20,49,.408,.471,12,14,.857,1,24,25,10,5,2,13,20,76
OG Anunoby,2020,SF,22,TOR,11,11,393,40,88,.455,17,41,.415,23,47,.489,.551,18,28,.643,26,50,76,13,11,13,16,27,115
D.J. Augustin,2020,PG,32,ORL,5,0,128,18,46,.391,8,17,.471,10,29,.345,.478,22,23,.957,0,10,10,30,1,0,12,6,66
J.J. Barea,2020,PG,35,DAL,1,0,5,0,1,.000,0,0,,0,1,.000,.000,3,3,1.000,0,0,0,0,0,0,1,1,3
Keita Bates-Diop,2020,SF,24,DEN,5,0,24,1,5,.200,0,0,,1,5,.200,.200,1,2,.500,3,3,6,1,0,0,0,0,3
Darius Bazley,2020,PF,19,OKC,7,0,126,13,31,.419,11,22,.500,2,9,.222,.597,9,10,.900,2,45,47,6,0,3,6,2,46
Patrick Beverley,2020,PG,31,LAC,8,8,166,20,39,.513,8,22,.364,12,17,.706,.615,2,4,.500,9,24,33,19,8,3,7,31,50
Khem Birch,2020,C,27,ORL,5,0,89,7,14,.500,0,0,,7,14,.500,.500,10,11,.909,9,16,25,7,1,0,5,11,24
Eric Bledsoe,2020,PG,30,MIL,9,9,267,38,98,.388,8,32,.250,30,66,.455,.429,21,26,.808,5,36,41,53,11,6,23,20,105
Bol Bol,2020,PF,20,DEN,4,0,21,5,9,.556,2,3,.667,3,6,.500,.667,7,8,.875,3,2,5,0,2,2,2,1,19
Chris Boucher,2020,C,27,TOR,7,0,43,3,11,.273,2,5,.400,1,6,.167,.364,0,1,.000,3,9,12,1,0,2,1,5,8
Tony Bradley,2020,C,22,UTA,6,0,48,2,9,.222,0,0,,2,9,.222,.222,5,7,.714,10,13,23,1,2,2,4,4,9
Jarrell Brantley,2020,PF,23,UTA,2,0,13,0,5,.000,0,3,.000,0,2,.000,.000,1,2,.500,3,1,4,2,0,1,1,4,1
Malcolm Brogdon,2020,PG,27,IND,4,4,160,26,65,.400,9,24,.375,17,41,.415,.469,25,28,.893,0,17,17,40,4,0,10,10,86
Jaylen Brown,2020,SG,23,BOS,17,17,672,137,288,.476,43,120,.358,94,168,.560,.550,53,63,.841,24,103,127,39,26,9,41,48,370
Sterling Brown,2020,SF,24,MIL,1,0,4,0,1,.000,0,1,.000,0,0,,.000,0,0,,0,1,1,0,0,0,0,0,0
Trey Burke,2020,PG,27,DAL,6,3,156,30,59,.508,8,17,.471,22,42,.524,.576,6,10,.600,2,17,19,12,8,2,6,14,74
Alec Burks,2020,SG,28,PHI,4,0,95,16,49,.327,3,16,.188,13,33,.394,.357,7,9,.778,7,8,15,7,1,3,3,7,42
Deonte Burton,2020,SF,26,OKC,1,0,2,0,0,,0,0,,0,0,,,0,0,,0,0,0,0,0,0,0,0,0
Jimmy Butler,2020,SF,30,MIA,21,21,806,144,295,.488,15,43,.349,129,252,.512,.514,164,191,.859,46,90,136,127,41,14,59,37,467
Bruno Caboclo,2020,C,24,HOU,2,0,7,1,2,.500,0,1,.000,1,1,1.000,.500,0,0,,0,3,3,0,1,0,0,2,2
Kentavious Caldwell-Pope,2020,SG,26,LAL,21,21,608,79,189,.418,45,119,.378,34,70,.486,.537,22,27,.815,8,36,44,28,21,4,15,40,225
DeMarre Carroll,2020,C,33,HOU,2,0,6,1,2,.500,0,0,,1,2,.500,.500,0,0,,0,3,3,1,0,0,0,1,2
Alex Caruso,2020,PG,25,LAL,21,1,510,48,113,.425,17,61,.279,31,52,.596,.500,24,30,.800,15,33,48,59,23,12,31,55,137
Tyson Chandler,2020,C,37,HOU,1,0,0,0,0,,0,0,,0,0,,,0,2,.000,0,0,0,0,0,0,0,0,0
Chris Chiozza,2020,PG,24,BRK,4,0,65,8,24,.333,5,16,.313,3,8,.375,.438,2,4,.500,1,5,6,17,5,0,3,7,23
Gary Clark,2020,SF,25,ORL,5,5,144,11,33,.333,11,32,.344,0,1,.000,.500,4,5,.800,4,24,28,7,5,2,2,7,37
Jordan Clarkson,2020,SG,27,UTA,7,0,200,45,97,.464,17,49,.347,28,48,.583,.552,10,10,1.000,2,22,24,15,6,0,7,15,117
Chris Clemons,2020,SG,22,HOU,2,0,8,2,5,.400,2,5,.400,0,0,,.600,1,2,.500,0,2,2,0,0,0,0,0,7
Antonius Cleveland,2020,SG,25,DAL,2,0,9,2,5,.400,0,0,,2,5,.400,.400,0,0,,1,0,1,0,1,0,0,1,4
Amir Coffey,2020,SG,22,LAC,3,0,7,0,3,.000,0,1,.000,0,2,.000,.000,2,2,1.000,0,0,0,4,1,0,0,0,2
Mike Conley,2020,PG,32,UTA,5,5,165,31,64,.484,18,34,.529,13,30,.433,.625,19,22,.864,3,11,14,26,8,1,5,10,99
Pat Connaughton,2020,SG,27,MIL,10,0,171,15,35,.429,8,23,.348,7,12,.583,.543,2,2,1.000,5,34,39,11,2,2,5,12,40
Quinn Cook,2020,PG,26,LAL,6,0,24,5,10,.500,2,4,.500,3,6,.500,.600,1,1,1.000,0,1,1,5,0,0,1,1,13
Tyler Cook,2020,SF,22,DEN,1,0,4,0,0,,0,0,,0,0,,,0,0,,0,2,2,0,0,0,0,0,0
Robert Covington,2020,C,29,HOU,12,12,379,47,95,.495,34,68,.500,13,27,.481,.674,6,7,.857,8,52,60,16,30,13,12,45,134
Torrey Craig,2020,SF,29,DEN,19,3,375,33,78,.423,11,42,.262,22,36,.611,.494,9,13,.692,13,49,62,13,7,7,9,44,86
Jae Crowder,2020,PF,29,MIA,21,21,660,81,201,.403,55,161,.342,26,40,.650,.540,35,46,.761,11,106,117,39,14,12,15,55,252
Seth Curry,2020,SG,29,DAL,6,0,173,31,53,.585,10,21,.476,21,32,.656,.679,5,5,1.000,2,9,11,8,6,0,8,14,77
Troy Daniels,2020,SG,28,DEN,6,0,30,6,12,.500,3,6,.500,3,6,.500,.625,1,2,.500,1,2,3,2,0,0,0,2,16
Anthony Davis,2020,PF,26,LAL,21,21,769,205,359,.571,23,60,.383,182,299,.609,.603,149,179,.832,55,149,204,73,26,30,53,56,582
Terence Davis,2020,SG,22,TOR,6,0,84,14,29,.483,8,19,.421,6,10,.600,.621,7,7,1.000,2,11,13,7,1,0,6,11,43
Hamidou Diallo,2020,SF,21,OKC,3,0,25,4,11,.364,1,5,.200,3,6,.500,.409,4,7,.571,2,4,6,1,0,2,2,0,13
Donte DiVincenzo,2020,SG,23,MIL,10,1,165,23,51,.451,7,21,.333,16,30,.533,.520,13,20,.650,8,24,32,12,7,3,10,21,66
Luka DonÄiÄ,2020,PG,20,DAL,6,6,215,64,128,.500,16,44,.364,48,84,.571,.563,42,64,.656,4,55,59,52,7,3,31,17,186
Luguentz Dort,2020,SF,20,OKC,6,6,175,27,76,.355,13,50,.260,14,26,.538,.441,8,15,.533,5,17,22,6,2,6,15,25,75
PJ Dozier,2020,SG,23,DEN,12,0,125,14,33,.424,2,8,.250,12,25,.480,.455,8,14,.571,2,16,18,12,2,2,8,13,38
Goran DragiÄ,2020,PG,33,MIA,17,16,553,119,268,.444,37,107,.346,82,161,.509,.513,49,61,.803,13,56,69,75,17,2,39,50,324
Jared Dudley,2020,PF,34,LAL,9,0,31,0,4,.000,0,3,.000,0,1,.000,.000,0,0,,0,2,2,0,4,1,2,2,0
Carsen Edwards,2020,SG,21,BOS,1,0,3,0,0,,0,0,,0,0,,,0,0,,0,1,1,0,0,0,0,0,0
Joel Embiid,2020,C,25,PHI,4,4,145,34,74,.459,4,16,.250,30,58,.517,.486,48,59,.814,11,38,49,5,6,5,15,18,120
James Ennis III,2020,SG,29,ORL,5,5,119,12,35,.343,4,16,.250,8,19,.421,.400,7,9,.778,6,23,29,6,5,2,6,19,35
Tacko Fall,2020,C,24,BOS,2,0,3,1,1,1.000,0,0,,1,1,1.000,1.000,1,2,.500,0,1,1,0,0,0,0,0,3
Terrance Ferguson,2020,SF,21,OKC,4,1,42,2,11,.182,2,10,.200,0,1,.000,.273,0,0,,1,3,4,1,1,0,1,3,6
Dorian Finney-Smith,2020,PF,26,DAL,6,6,191,23,52,.442,11,30,.367,12,22,.545,.548,4,5,.800,12,22,34,19,7,3,9,22,61
Evan Fournier,2020,SF,27,ORL,5,5,171,20,57,.351,12,35,.343,8,22,.364,.456,12,17,.706,3,17,20,13,6,3,9,10,64
Michael Frazier,2020,SG,25,HOU,4,0,12,1,4,.250,1,2,.500,0,2,.000,.375,0,0,,1,3,4,2,0,0,1,0,3
Enes Freedom,2020,C,27,BOS,11,0,102,22,42,.524,1,1,1.000,21,41,.512,.536,5,10,.500,19,24,43,7,0,0,4,19,50
Markelle Fultz,2020,PG,21,ORL,5,5,147,24,60,.400,6,16,.375,18,44,.409,.450,6,7,.857,0,11,11,26,5,3,13,20,60
Wenyen Gabriel,2020,PF,22,POR,4,2,53,9,15,.600,2,5,.400,7,10,.700,.667,1,2,.500,7,3,10,4,2,2,5,16,21
Danilo Gallinari,2020,PF,31,OKC,7,7,212,32,79,.405,12,37,.324,20,42,.476,.481,29,30,.967,5,33,38,7,5,1,15,11,105
Marc Gasol,2020,C,35,TOR,11,11,228,25,64,.391,5,27,.185,20,37,.541,.430,11,15,.733,4,44,48,29,5,7,16,32,66
Paul George,2020,SF,29,LAC,13,13,479,88,221,.398,37,111,.333,51,110,.464,.482,50,55,.909,14,65,79,49,19,7,40,49,263
Shai Gilgeous-Alexander,2020,SG,21,OKC,7,7,279,39,90,.433,14,35,.400,25,55,.455,.511,22,23,.957,3,34,37,29,7,3,15,17,114
Rudy Gobert,2020,C,27,UTA,7,7,270,48,74,.649,0,0,,48,74,.649,.649,22,42,.524,24,56,80,8,4,10,9,26,118
Eric Gordon,2020,SF,31,HOU,12,12,410,72,176,.409,29,90,.322,43,86,.500,.491,35,40,.875,6,26,32,36,10,7,24,26,208
Jerami Grant,2020,PF,25,DEN,19,16,653,71,175,.406,31,95,.326,40,80,.500,.494,48,54,.889,8,55,63,25,11,15,25,59,221
Danny Green,2020,SG,32,LAL,21,21,525,59,170,.347,39,115,.339,20,55,.364,.462,10,15,.667,25,41,66,26,20,16,12,48,167
JaMychal Green,2020,PF,29,LAC,13,0,222,31,55,.564,10,23,.435,21,32,.656,.655,7,9,.778,13,36,49,7,2,3,5,29,79
Javonte Green,2020,SG,26,BOS,1,0,6,1,2,.500,1,2,.500,0,0,,.750,0,0,,0,1,1,0,0,0,0,1,3
Jeff Green,2020,C,33,HOU,12,0,341,51,103,.495,23,54,.426,28,49,.571,.607,14,17,.824,5,55,60,19,6,6,15,27,139
Donta Hall,2020,C,22,BRK,3,0,20,3,5,.600,0,0,,3,5,.600,.600,1,4,.250,3,2,5,0,0,2,1,1,7
Tim Hardaway Jr.,2020,SG,27,DAL,6,6,204,40,95,.421,19,54,.352,21,41,.512,.521,8,11,.727,3,18,21,11,2,0,3,16,107
James Harden,2020,SG,30,HOU,12,12,448,109,228,.478,39,117,.333,70,111,.631,.564,98,116,.845,12,55,67,92,18,10,45,43,355
Montrezl Harrell,2020,C,26,LAC,13,0,243,47,82,.573,1,5,.200,46,77,.597,.579,41,68,.603,11,27,38,5,5,7,12,28,136
Gary Harris,2020,SG,25,DEN,14,12,379,34,90,.378,19,52,.365,15,38,.395,.483,17,22,.773,7,21,28,24,16,4,21,45,104
Joe Harris,2020,SF,28,BRK,2,2,72,12,23,.522,7,12,.583,5,11,.455,.674,2,4,.500,2,18,20,2,1,0,3,9,33
Tobias Harris,2020,PF,27,PHI,4,4,149,23,60,.383,2,15,.133,21,45,.467,.400,15,19,.789,14,24,38,16,2,1,5,11,63
Gordon Hayward,2020,SF,29,BOS,5,1,157,20,50,.400,7,24,.292,13,26,.500,.470,7,8,.875,3,17,20,14,7,2,7,10,54
Tyler Herro,2020,SG,20,MIA,21,5,706,120,277,.433,48,128,.375,72,149,.483,.520,47,54,.870,7,100,107,77,8,2,42,31,335
Mario Hezonja,2020,PF,24,POR,5,0,68,9,22,.409,2,7,.286,7,15,.467,.455,3,4,.750,2,14,16,6,3,0,3,8,23
George Hill,2020,PG,33,MIL,10,1,268,32,67,.478,10,28,.357,22,39,.564,.552,21,26,.808,5,19,24,31,6,0,16,17,95
Solomon Hill,2020,PF,28,MIA,7,0,42,5,9,.556,2,6,.333,3,3,1.000,.667,0,0,,1,6,7,3,1,0,0,5,12
Jaylen Hoard,2020,PF,20,POR,3,0,41,7,12,.583,0,0,,7,12,.583,.583,0,0,,5,4,9,1,0,0,2,5,14
Aaron Holiday,2020,PG,23,IND,4,2,72,12,21,.571,4,9,.444,8,12,.667,.667,3,5,.600,1,4,5,10,4,0,4,10,31
Justin Holiday,2020,SF,30,IND,4,2,131,10,21,.476,8,16,.500,2,5,.400,.667,1,3,.333,4,11,15,3,6,5,3,8,29
Rondae Hollis-Jefferson,2020,PF,25,TOR,5,0,39,4,10,.400,0,1,.000,4,9,.444,.400,6,8,.750,5,5,10,3,2,1,1,5,14
Al Horford,2020,C,33,PHI,4,3,129,12,25,.480,0,4,.000,12,21,.571,.480,4,7,.571,9,20,29,9,1,5,3,14,28
Talen Horton-Tucker,2020,SG,19,LAL,2,0,17,6,12,.500,2,5,.400,4,7,.571,.583,0,0,,0,5,5,0,2,0,0,4,14
Danuel House Jr.,2020,SF,26,HOU,9,4,279,37,85,.435,19,53,.358,18,32,.563,.547,10,13,.769,10,42,52,13,8,0,7,22,103
Dwight Howard,2020,C,34,LAL,18,7,282,39,57,.684,1,2,.500,38,55,.691,.693,25,45,.556,32,51,83,9,8,8,16,55,104
Serge Ibaka,2020,C,30,TOR,11,0,251,63,110,.573,23,45,.511,40,65,.615,.677,14,14,1.000,17,68,85,13,2,14,12,27,163
Andre Iguodala,2020,SF,36,MIA,21,0,410,30,65,.462,14,39,.359,16,26,.615,.569,5,7,.714,11,43,54,31,17,13,14,44,79
Ersan Ä°lyasova,2020,PF,32,MIL,3,0,23,3,9,.333,1,5,.200,2,4,.500,.389,2,2,1.000,0,4,4,0,2,0,1,3,9
Joe Ingles,2020,PF,32,UTA,7,7,234,22,54,.407,14,40,.350,8,14,.571,.537,6,6,1.000,1,23,24,33,4,1,4,15,64
Wes Iwundu,2020,SF,25,ORL,5,0,76,6,20,.300,4,7,.571,2,13,.154,.400,5,8,.625,1,10,11,4,3,2,3,5,21
Justin Jackson,2020,PF,24,DAL,3,0,16,1,6,.167,0,3,.000,1,3,.333,.167,2,4,.500,0,3,3,0,0,0,0,1,4
Reggie Jackson,2020,SG,29,LAC,12,1,170,21,48,.438,17,32,.531,4,16,.250,.615,0,0,,2,19,21,11,2,1,5,18,59
LeBron James,2020,PG,35,LAL,21,21,762,214,382,.560,44,119,.370,170,263,.646,.618,108,150,.720,28,198,226,184,26,18,84,40,580
Alize Johnson,2020,PF,23,IND,1,0,0,0,0,,0,0,,0,0,,,0,0,,0,0,0,0,0,0,0,0,0
B.J. Johnson,2020,SF,24,ORL,1,0,4,1,2,.500,1,1,1.000,0,1,.000,.750,0,0,,0,2,2,0,0,0,0,0,3
Stanley Johnson,2020,PF,23,TOR,3,0,20,5,11,.455,2,5,.400,3,6,.500,.545,1,1,1.000,1,3,4,6,0,0,1,3,13
Tyler Johnson,2020,SG,27,BRK,4,2,93,21,46,.457,11,28,.393,10,18,.556,.576,2,2,1.000,0,7,7,9,0,1,3,11,55
Nikola JokiÄ,2020,C,24,DEN,19,19,694,178,343,.519,42,98,.429,136,245,.555,.580,66,79,.835,37,150,187,109,20,15,62,68,464
Derrick Jones Jr.,2020,SF,22,MIA,15,0,97,8,17,.471,4,9,.444,4,8,.500,.588,2,5,.400,6,6,12,7,6,5,2,12,22
Michael Kidd-Gilchrist,2020,PF,26,DAL,6,0,55,4,14,.286,2,9,.222,2,5,.400,.357,4,6,.667,2,4,6,3,1,1,1,8,14
Maxi Kleber,2020,PF,28,DAL,6,6,203,13,39,.333,5,26,.192,8,13,.615,.397,9,12,.750,10,29,39,9,2,7,4,20,40
Furkan Korkmaz,2020,SG,22,PHI,4,0,40,0,7,.000,0,6,.000,0,1,.000,.000,3,5,.600,0,6,6,2,1,0,2,3,3
Kyle Korver,2020,SF,38,MIL,10,0,119,20,47,.426,15,37,.405,5,10,.500,.585,7,7,1.000,1,7,8,1,3,1,5,9,62
Rodions Kurucs,2020,PF,21,BRK,4,1,58,11,20,.550,0,8,.000,11,12,.917,.550,0,2,.000,3,10,13,3,1,2,3,9,22
Kyle Kuzma,2020,PF,24,LAL,21,0,484,77,179,.430,26,83,.313,51,96,.531,.503,29,37,.784,18,47,65,17,6,7,21,50,209
Romeo Langford,2020,SG,20,BOS,7,0,46,4,10,.400,1,2,.500,3,8,.375,.450,1,2,.500,0,3,3,2,1,0,2,4,10
Vic Law,2020,PF,24,ORL,1,0,4,1,1,1.000,1,1,1.000,0,0,,1.500,0,0,,0,2,2,1,0,0,0,0,3
Kawhi Leonard,2020,SF,28,LAC,13,13,511,131,268,.489,24,73,.329,107,195,.549,.534,81,94,.862,24,97,121,72,30,11,33,29,367
Meyers Leonard,2020,C,27,MIA,3,2,31,5,8,.625,2,4,.500,3,4,.750,.750,2,2,1.000,0,1,1,3,1,0,0,4,14
Caris LeVert,2020,SG,25,BRK,4,4,140,27,73,.370,9,21,.429,18,52,.346,.432,18,25,.720,8,16,24,38,5,1,13,7,81
Damian Lillard,2020,PG,29,POR,4,4,143,26,64,.406,13,33,.394,13,31,.419,.508,32,33,.970,1,13,14,17,2,1,14,4,97
Brook Lopez,2020,C,31,MIL,10,10,328,61,114,.535,21,53,.396,40,61,.656,.627,15,20,.750,19,36,55,5,10,13,12,27,158
Robin Lopez,2020,C,31,MIL,3,0,21,3,4,.750,0,0,,3,4,.750,.750,0,0,,0,4,4,0,0,0,0,2,6
Kyle Lowry,2020,PG,33,TOR,11,11,413,62,148,.419,23,72,.319,39,76,.513,.497,48,60,.800,8,64,72,64,19,8,28,40,195
TimothÃ© Luwawu-Cabarrot,2020,SF,24,BRK,4,3,131,20,59,.339,13,39,.333,7,20,.350,.449,11,12,.917,1,14,15,6,3,0,8,14,64
Terance Mann,2020,SF,23,LAC,13,0,27,2,5,.400,0,2,.000,2,3,.667,.400,0,0,,0,7,7,1,1,0,2,4,4
Boban MarjanoviÄ,2020,C,31,DAL,6,0,82,17,30,.567,0,1,.000,17,29,.586,.567,7,9,.778,6,29,35,5,0,2,3,9,41
Jeremiah Martin,2020,PG,23,BRK,3,0,27,4,14,.286,3,5,.600,1,9,.111,.393,1,1,1.000,0,3,3,4,0,1,2,2,12
Frank Mason III,2020,PG,25,MIL,2,0,2,0,0,,0,0,,0,0,,,0,0,,0,0,0,1,0,0,0,0,0
Wesley Matthews,2020,SG,33,MIL,10,10,246,24,57,.421,17,43,.395,7,14,.500,.570,7,10,.700,6,12,18,9,9,4,7,20,72
CJ McCollum,2020,SG,28,POR,5,5,196,44,99,.444,13,35,.371,31,64,.484,.510,15,22,.682,5,24,29,16,6,2,15,10,116
T.J. McConnell,2020,PG,27,IND,3,0,28,3,8,.375,0,0,,3,8,.375,.375,1,2,.500,0,6,6,7,0,0,2,4,7
Doug McDermott,2020,PF,28,IND,4,0,54,4,15,.267,2,10,.200,2,5,.400,.333,0,0,,0,3,3,1,1,0,1,3,10
JaVale McGee,2020,C,32,LAL,14,11,135,20,32,.625,0,2,.000,20,30,.667,.625,1,2,.500,16,28,44,7,2,10,9,22,41
Rodney McGruder,2020,SG,28,LAC,5,0,16,3,5,.600,2,3,.667,1,2,.500,.800,0,0,,1,3,4,2,0,0,0,0,8
Ben McLemore,2020,SF,26,HOU,11,0,130,15,40,.375,14,36,.389,1,4,.250,.550,0,0,,2,9,11,6,4,0,3,8,44
Khris Middleton,2020,SF,28,MIL,10,10,355,71,180,.394,23,65,.354,48,115,.417,.458,38,46,.826,5,64,69,60,11,2,34,41,203
Malcolm Miller,2020,SF,26,TOR,1,0,5,1,3,.333,1,1,1.000,0,2,.000,.500,0,0,,0,0,0,0,0,0,0,2,3
Paul Millsap,2020,PF,34,DEN,19,19,459,47,118,.398,15,44,.341,32,74,.432,.462,43,54,.796,26,63,89,23,12,9,25,49,152
Shake Milton,2020,SG,23,PHI,4,4,126,21,44,.477,10,25,.400,11,19,.579,.591,6,7,.857,1,12,13,11,2,0,6,13,58
Donovan Mitchell,2020,SG,23,UTA,7,7,264,83,157,.529,33,64,.516,50,93,.538,.634,55,58,.948,6,29,35,34,7,2,29,11,254
Juwan Morgan,2020,PF,22,UTA,7,2,86,3,12,.250,2,10,.200,1,2,.500,.333,2,6,.333,6,15,21,5,2,0,1,11,10
Marcus Morris,2020,PF,30,LAC,13,13,388,56,111,.505,28,59,.475,28,52,.538,.631,13,14,.929,11,52,63,21,11,1,9,39,153
Markieff Morris,2020,PF,30,LAL,21,2,385,44,98,.449,29,69,.420,15,29,.517,.597,7,9,.778,12,52,64,20,6,3,17,54,124
Monte Morris,2020,PG,24,DEN,19,4,406,66,133,.496,12,40,.300,54,93,.581,.541,28,34,.824,4,25,29,52,12,2,10,20,172
Emmanuel Mudiay,2020,PG,23,UTA,3,0,34,5,14,.357,2,3,.667,3,11,.273,.429,1,2,.500,1,5,6,2,0,1,1,0,13
Jamal Murray,2020,PG,22,DEN,19,19,753,186,368,.505,62,137,.453,124,231,.537,.590,70,78,.897,20,72,92,126,18,6,53,42,504
DÅ¾anan Musa,2020,SF,20,BRK,3,0,39,2,11,.182,0,6,.000,2,5,.400,.182,10,14,.714,1,2,3,4,0,1,3,2,14
Mike Muscala,2020,C,28,OKC,2,0,20,1,2,.500,1,1,1.000,0,1,.000,.750,0,0,,0,4,4,1,0,0,0,2,3
Abdel Nader,2020,SF,26,OKC,3,0,25,1,7,.143,1,5,.200,0,2,.000,.214,1,2,.500,1,2,3,0,1,2,0,1,4
Raul Neto,2020,PG,27,PHI,2,0,26,3,9,.333,2,5,.400,1,4,.250,.444,0,0,,0,3,3,3,1,0,1,0,8
Georges Niang,2020,PF,26,UTA,7,0,114,22,44,.500,12,29,.414,10,15,.667,.636,2,2,1.000,4,11,15,4,0,1,2,9,58
Joakim Noah,2020,C,34,LAC,2,0,2,0,0,,0,0,,0,0,,,0,0,,0,0,0,0,0,0,0,0,0
Nerlens Noel,2020,C,25,OKC,7,0,97,8,17,.471,0,1,.000,8,16,.500,.471,5,10,.500,5,24,29,3,2,5,2,15,21
Kendrick Nunn,2020,PG,24,MIA,15,0,239,36,92,.391,12,43,.279,24,49,.490,.457,8,8,1.000,3,29,32,20,3,3,12,21,92
Jusuf NurkiÄ,2020,C,25,POR,5,5,161,25,57,.439,3,11,.273,22,46,.478,.465,18,23,.783,14,38,52,18,7,1,13,21,71
Royce O'Neale,2020,SF,26,UTA,7,7,249,13,32,.406,10,22,.455,3,10,.300,.563,3,6,.500,3,35,38,19,9,2,13,25,39
Kyle O'Quinn,2020,C,29,PHI,1,0,6,0,0,,0,0,,0,0,,,0,0,,0,1,1,1,0,0,2,3,0
Semi Ojeleye,2020,PF,25,BOS,13,0,122,7,28,.250,5,23,.217,2,5,.400,.339,2,2,1.000,2,10,12,1,3,0,1,9,21
Victor Oladipo,2020,SG,27,IND,4,4,123,22,56,.393,12,33,.364,10,23,.435,.500,15,16,.938,0,13,13,10,9,0,14,14,71
Kelly Olynyk,2020,C,28,MIA,17,0,258,45,95,.474,17,49,.347,28,46,.609,.563,23,28,.821,13,66,79,19,4,8,13,35,130
Miye Oni,2020,SF,22,UTA,2,0,14,3,6,.500,1,4,.250,2,2,1.000,.583,0,0,,2,2,4,0,1,1,1,2,7
Patrick Patterson,2020,PF,30,LAC,2,0,10,3,3,1.000,3,3,1.000,0,0,,1.500,0,0,,0,1,1,4,0,0,0,1,9
Chris Paul,2020,PG,34,OKC,7,7,261,55,112,.491,16,43,.372,39,69,.565,.563,23,26,.885,3,49,52,37,11,3,23,18,149
Norvel Pelle,2020,C,26,PHI,1,0,7,0,0,,0,0,,0,0,,,0,0,,0,0,0,0,1,1,0,0,0
Mason Plumlee,2020,C,29,DEN,19,0,206,19,39,.487,0,1,.000,19,38,.500,.487,8,12,.667,31,30,61,25,4,8,11,40,46
Vincent Poirier,2020,C,26,BOS,1,0,2,0,0,,0,0,,0,0,,,0,0,,0,0,0,1,1,0,0,0,0
Michael Porter Jr.,2020,SF,21,DEN,19,3,451,78,164,.476,34,89,.382,44,75,.587,.579,26,35,.743,21,106,127,16,13,6,25,43,216
Kristaps PorziÅÄ£is,2020,C,24,DAL,3,3,94,21,40,.525,9,17,.529,12,23,.522,.638,20,23,.870,3,23,26,2,0,3,3,9,71
Norman Powell,2020,SG,26,TOR,11,0,273,51,104,.490,22,52,.423,29,52,.558,.596,23,29,.793,4,22,26,11,6,3,11,29,147
Josh Reaves,2020,SF,22,DAL,2,0,9,1,3,.333,0,1,.000,1,2,.500,.333,2,2,1.000,0,2,2,1,0,1,1,1,4
Josh Richardson,2020,SG,26,PHI,4,4,144,20,56,.357,10,28,.357,10,28,.357,.446,17,18,.944,4,11,15,13,2,2,8,12,67
Austin Rivers,2020,SG,27,HOU,12,0,211,19,61,.311,9,35,.257,10,26,.385,.385,10,13,.769,2,28,30,16,7,1,8,22,57
Andre Roberson,2020,SF,28,OKC,1,0,3,0,1,.000,0,1,.000,0,0,,.000,0,0,,0,0,0,0,0,0,0,1,0
Duncan Robinson,2020,SG,25,MIA,21,21,600,75,176,.426,62,156,.397,13,20,.650,.602,33,38,.868,5,53,58,38,14,6,16,65,245
Rajon Rondo,2020,PG,33,LAL,16,0,395,55,121,.455,20,50,.400,35,71,.493,.537,13,19,.684,13,56,69,105,22,2,34,36,143
Terrence Ross,2020,SG,28,ORL,5,0,135,30,64,.469,10,30,.333,20,34,.588,.547,12,14,.857,1,21,22,5,4,1,8,14,82
JaKarr Sampson,2020,PF,26,IND,4,0,50,10,16,.625,0,0,,10,16,.625,.625,0,0,,1,12,13,4,2,0,2,10,20
Dennis SchrÃ¶der,2020,PG,26,OKC,7,0,227,44,109,.404,13,45,.289,31,64,.484,.463,20,25,.800,2,24,26,25,4,1,17,15,121
Mike Scott,2020,PF,31,PHI,4,0,20,1,5,.200,0,2,.000,1,3,.333,.200,4,4,1.000,2,6,8,1,0,0,0,2,6
Landry Shamet,2020,SG,22,LAC,13,4,243,24,59,.407,15,42,.357,9,17,.529,.534,5,7,.714,0,22,22,17,6,3,13,18,68
Pascal Siakam,2020,PF,25,TOR,11,11,418,72,182,.396,10,53,.189,62,129,.481,.423,33,46,.717,14,69,83,42,12,4,22,33,187
Anfernee Simons,2020,SG,20,POR,4,0,82,8,26,.308,6,14,.429,2,12,.167,.423,5,6,.833,1,10,11,10,6,0,4,7,27
Marcus Smart,2020,SG,25,BOS,17,16,648,78,198,.394,41,123,.333,37,75,.493,.497,49,56,.875,10,79,89,78,21,8,45,55,246
J.R. Smith,2020,SG,34,LAL,10,0,75,7,26,.269,6,22,.273,1,4,.250,.385,0,0,,0,3,3,3,2,0,7,11,20
Edmond Sumner,2020,SG,24,IND,3,0,41,2,7,.286,0,3,.000,2,4,.500,.286,2,2,1.000,1,5,6,0,0,0,2,5,6
Jayson Tatum,2020,PF,21,BOS,17,17,690,145,334,.434,47,126,.373,98,208,.471,.504,100,123,.813,22,148,170,85,17,20,48,41,437
Garrett Temple,2020,SG,33,BRK,4,4,137,17,49,.347,9,36,.250,8,13,.615,.439,5,6,.833,0,11,11,8,3,1,6,12,48
Daniel Theis,2020,C,27,BOS,17,17,482,61,117,.521,4,26,.154,57,91,.626,.538,26,33,.788,32,89,121,25,6,21,15,66,152
Lance Thomas,2020,PF,31,BRK,3,0,17,1,5,.200,0,2,.000,1,3,.333,.200,2,4,.500,1,2,3,0,0,1,0,2,4
Matt Thomas,2020,SG,25,TOR,10,0,84,13,21,.619,5,12,.417,8,9,.889,.738,0,0,,1,13,14,7,1,1,1,6,31
Matisse Thybulle,2020,SG,22,PHI,4,1,75,3,7,.429,1,4,.250,2,3,.667,.500,0,0,,1,6,7,2,3,1,2,6,7
Gary Trent Jr.,2020,SF,21,POR,5,1,153,16,45,.356,10,24,.417,6,21,.286,.467,6,7,.857,5,5,10,3,4,0,5,16,48
P.J. Tucker,2020,PF,34,HOU,12,12,414,35,88,.398,25,67,.373,10,21,.476,.540,0,0,,23,63,86,18,13,3,12,47,95
Rayjon Tucker,2020,SG,22,UTA,2,0,11,2,5,.400,1,3,.333,1,2,.500,.500,0,0,,0,0,0,0,0,0,1,1,5
Myles Turner,2020,C,23,IND,4,4,146,25,44,.568,6,14,.429,19,30,.633,.636,7,16,.438,11,32,43,3,2,16,9,13,63
Fred VanVleet,2020,SG,25,TOR,11,11,430,76,190,.400,43,110,.391,33,80,.413,.513,21,25,.840,5,43,48,76,18,7,22,27,216
Gabe Vincent,2020,PG,23,MIA,1,0,0,0,0,,0,0,,0,0,,,0,0,,0,0,0,0,0,0,0,0,0
Noah Vonleh,2020,C,24,DEN,1,0,3,0,1,.000,0,0,,0,1,.000,.000,0,0,,0,0,0,0,0,0,0,0,0
Nikola VuÄeviÄ,2020,C,29,ORL,5,5,185,56,111,.505,18,44,.409,38,67,.567,.586,10,11,.909,9,46,55,20,4,3,13,13,140
Dion Waiters,2020,SG,28,LAL,5,0,38,4,12,.333,0,4,.000,4,8,.500,.333,2,2,1.000,0,2,2,2,1,1,1,2,10
Kemba Walker,2020,PG,29,BOS,17,17,628,113,256,.441,39,126,.310,74,130,.569,.518,69,81,.852,6,63,69,86,15,7,32,43,334
Brad Wanamaker,2020,PG,30,BOS,17,0,273,29,60,.483,12,27,.444,17,33,.515,.583,14,16,.875,2,32,34,30,12,4,18,32,84
T.J. Warren,2020,SF,26,IND,4,4,156,32,68,.471,7,19,.368,25,49,.510,.522,9,9,1.000,5,20,25,12,9,1,11,16,80
Tremont Waters,2020,PG,22,BOS,1,0,2,0,1,.000,0,1,.000,0,0,,.000,0,0,,0,1,1,1,0,0,0,0,0
Paul Watson,2020,SF,25,TOR,2,0,9,1,2,.500,0,0,,1,2,.500,.500,0,0,,0,0,0,1,1,0,0,0,2
Russell Westbrook,2020,PG,31,HOU,8,8,262,59,140,.421,8,33,.242,51,107,.477,.450,17,32,.531,11,45,56,37,12,2,30,23,143
Hassan Whiteside,2020,C,30,POR,5,3,106,13,24,.542,1,1,1.000,12,23,.522,.563,7,14,.500,7,28,35,2,1,10,6,17,34
Grant Williams,2020,PF,21,BOS,17,0,170,15,26,.577,10,17,.588,5,9,.556,.769,7,10,.700,7,19,26,6,2,5,4,33,47
Lou Williams,2020,PG,33,LAC,13,0,341,62,146,.425,12,51,.235,50,95,.526,.466,30,37,.811,7,34,41,55,10,2,21,18,166
Marvin Williams,2020,PF,33,MIL,10,0,179,21,47,.447,10,23,.435,11,24,.458,.553,3,3,1.000,13,35,48,9,5,3,3,14,55
Robert Williams,2020,C,22,BOS,13,0,149,23,31,.742,0,1,.000,23,30,.767,.742,2,6,.333,22,29,51,10,3,6,7,18,48
Nigel Williams-Goss,2020,PG,25,UTA,1,0,2,0,0,,0,0,,0,0,,,0,0,,0,0,0,1,0,0,0,0,0
Delon Wright,2020,PG,27,DAL,4,0,53,6,10,.600,1,2,.500,5,8,.625,.650,3,5,.600,1,2,3,7,5,0,5,2,16
Ivica Zubac,2020,C,22,LAC,13,13,320,44,78,.564,0,0,,44,78,.564,.564,30,37,.811,31,62,93,8,2,10,12,34,118
Precious Achiuwa,2021,PF,21,MIA,3,0,12,3,4,.750,0,0,,3,4,.750,.750,1,4,.250,0,6,6,0,0,2,4,1,7
Bam Adebayo,2021,C,23,MIA,4,4,136,26,57,.456,0,0,,26,57,.456,.456,10,13,.769,14,23,37,17,5,2,11,11,62
Ty-Shon Alexander,2021,SG,22,PHO,1,0,1,1,1,1.000,0,0,,1,1,1.000,1.000,0,0,,0,0,0,0,0,0,0,0,2
Grayson Allen,2021,SG,25,MEM,5,0,116,12,33,.364,8,21,.381,4,12,.333,.485,0,1,.000,3,10,13,1,2,1,1,13,32
Kyle Anderson,2021,PF,27,MEM,5,5,142,18,42,.429,3,12,.250,15,30,.500,.464,3,4,.750,4,21,25,16,14,0,4,9,42
Giannis Antetokounmpo,2021,PF,26,MIL,21,21,800,250,439,.569,13,70,.186,237,369,.642,.584,121,206,.587,59,210,269,108,21,25,64,61,634
Thanasis Antetokounmpo,2021,SF,28,MIL,13,0,45,2,7,.286,0,0,,2,7,.286,.286,5,6,.833,3,7,10,3,5,2,3,12,9
Carmelo Anthony,2021,PF,36,POR,6,0,143,25,60,.417,14,37,.378,11,23,.478,.533,10,11,.909,2,17,19,9,2,1,7,15,74
Trevor Ariza,2021,SF,35,MIA,4,4,96,7,23,.304,5,17,.294,2,6,.333,.413,0,0,,2,21,23,2,3,1,3,11,19
Deandre Ayton,2021,C,22,PHO,22,22,801,154,234,.658,0,0,,154,234,.658,.658,39,53,.736,67,193,260,25,18,24,28,63,347
Udoka Azubuike,2021,C,21,UTA,1,0,1,0,0,,0,0,,0,0,,,0,0,,0,1,1,0,0,0,0,0,0
Desmond Bane,2021,SG,22,MEM,5,0,99,11,19,.579,6,12,.500,5,7,.714,.737,0,0,,2,15,17,10,4,2,3,6,28
RJ Barrett,2021,SG,20,NYK,5,5,162,26,67,.388,8,28,.286,18,39,.462,.448,12,15,.800,4,32,36,15,4,2,2,11,72
Will Barton,2021,SF,30,DEN,3,1,83,19,43,.442,7,21,.333,12,22,.545,.523,4,4,1.000,1,12,13,8,2,1,4,4,49
Nicolas Batum,2021,SF,32,LAC,19,10,555,53,109,.486,28,72,.389,25,37,.676,.615,19,23,.826,19,86,105,39,24,10,6,26,153
Bradley Beal,2021,SG,27,WAS,5,5,195,56,123,.455,7,32,.219,49,91,.538,.484,31,36,.861,6,25,31,21,4,3,20,6,150
DÄvis BertÄns,2021,PF,28,WAS,4,2,106,11,27,.407,8,23,.348,3,4,.750,.556,7,7,1.000,0,11,11,1,1,2,1,12,37
Patrick Beverley,2021,PG,32,LAC,17,7,323,29,68,.426,13,37,.351,16,31,.516,.522,12,14,.857,11,30,41,24,12,12,4,35,83
Nemanja Bjelica,2021,PF,32,MIA,2,0,30,5,11,.455,4,8,.500,1,3,.333,.636,4,6,.667,1,4,5,2,2,1,0,5,18
Keljin Blevins,2021,SF,25,POR,2,0,4,1,2,.500,0,1,.000,1,1,1.000,.500,0,0,,0,0,0,0,0,0,0,1,2
Bogdan BogdanoviÄ,2021,SG,28,ATL,18,18,598,97,249,.390,47,143,.329,50,106,.472,.484,12,17,.706,11,64,75,52,29,5,27,50,253
Bojan BogdanoviÄ,2021,SF,31,UTA,11,11,390,64,137,.467,35,76,.461,29,61,.475,.595,36,41,.878,6,41,47,16,10,0,23,27,199
Bol Bol,2021,PF,21,DEN,3,0,6,0,1,.000,0,1,.000,0,0,,.000,0,0,,0,1,1,2,0,0,0,0,0
Isaac Bonga,2021,SF,21,WAS,4,0,10,0,5,.000,0,3,.000,0,2,.000,.000,0,0,,0,0,0,0,0,1,0,0,0
Devin Booker,2021,SG,24,PHO,22,22,889,212,474,.447,44,137,.321,168,337,.499,.494,133,147,.905,15,109,124,100,18,4,81,76,601
Jarrell Brantley,2021,PF,24,UTA,2,0,3,0,1,.000,0,0,,0,1,.000,.000,1,2,.500,0,1,1,0,0,0,1,0,1
Mikal Bridges,2021,SF,24,PHO,22,22,707,92,190,.484,35,95,.368,57,95,.600,.576,25,28,.893,20,74,94,36,22,15,16,41,244
Dillon Brooks,2021,SF,25,MEM,5,5,175,50,97,.515,8,20,.400,42,77,.545,.557,21,26,.808,5,16,21,11,7,2,9,17,129
Bruce Brown,2021,PG,24,BRK,12,5,277,40,79,.506,2,11,.182,38,68,.559,.519,13,16,.813,23,38,61,25,8,5,11,31,95
Jalen Brunson,2021,PG,24,DAL,7,0,114,20,44,.455,6,13,.462,14,31,.452,.523,10,13,.769,6,12,18,10,0,0,4,6,56
Elijah Bryant,2021,SG,25,MIL,11,0,50,7,20,.350,0,8,.000,7,12,.583,.350,0,0,,2,10,12,4,2,1,2,1,14
Reggie Bullock,2021,SF,29,NYK,5,5,162,15,39,.385,10,29,.345,5,10,.500,.513,4,5,.800,5,12,17,6,3,1,4,11,44
Trey Burke,2021,PG,28,DAL,2,0,17,0,7,.000,0,3,.000,0,4,.000,.000,1,2,.500,1,0,1,1,0,0,0,1,1
Alec Burks,2021,SG,29,NYK,5,0,128,24,56,.429,8,24,.333,16,32,.500,.500,14,19,.737,5,20,25,13,1,0,4,11,70
Jimmy Butler,2021,SF,31,MIA,4,4,154,19,64,.297,4,15,.267,15,49,.306,.328,16,22,.727,6,24,30,28,5,1,9,6,58
Kentavious Caldwell-Pope,2021,SG,27,LAL,5,5,146,11,29,.379,4,19,.211,7,10,.700,.448,5,5,1.000,2,12,14,5,5,0,2,15,31
Facundo Campazzo,2021,PG,29,DEN,10,9,270,29,74,.392,19,48,.396,10,26,.385,.520,16,19,.842,7,23,30,41,14,4,15,35,93
Vlatko ÄanÄar,2021,PF,23,DEN,5,0,21,3,3,1.000,1,1,1.000,2,2,1.000,1.167,4,5,.800,0,3,3,1,1,1,1,0,11
Clint Capela,2021,C,26,ATL,18,18,569,82,136,.603,0,0,,82,136,.603,.603,17,39,.436,61,140,201,17,12,19,18,46,181
Jevon Carter,2021,PG,25,PHO,7,0,22,3,8,.375,0,2,.000,3,6,.500,.375,0,2,.000,0,2,2,4,0,0,0,0,6
Alex Caruso,2021,PG,26,LAL,6,0,121,14,38,.368,5,17,.294,9,21,.429,.434,2,2,1.000,2,6,8,3,1,4,7,12,35
Willie Cauley-Stein,2021,C,27,DAL,6,0,63,6,9,.667,0,0,,6,9,.667,.667,3,3,1.000,3,13,16,3,2,4,3,8,15
Chris Chiozza,2021,PG,25,BRK,6,0,19,2,7,.286,1,3,.333,1,4,.250,.357,0,0,,0,1,1,1,1,0,1,2,5
Brandon Clarke,2021,PF,24,MEM,2,0,9,1,2,.500,0,0,,1,2,.500,.500,0,0,,0,1,1,0,0,1,0,0,2
Jordan Clarkson,2021,SG,28,UTA,11,0,298,67,165,.406,34,97,.351,33,68,.485,.509,25,26,.962,6,28,34,17,7,3,23,15,193
Nic Claxton,2021,C,21,BRK,12,0,130,14,29,.483,0,0,,14,29,.483,.483,2,3,.667,14,19,33,7,4,12,4,20,30
Amir Coffey,2021,SG,23,LAC,10,0,16,3,4,.750,1,1,1.000,2,3,.667,.875,0,1,.000,0,2,2,1,1,0,1,0,7
John Collins,2021,PF,23,ATL,18,18,576,100,182,.549,20,56,.357,80,126,.635,.604,30,36,.833,36,121,157,16,8,11,23,59,250
Mike Conley,2021,PG,33,UTA,6,6,176,29,68,.426,18,37,.486,11,31,.355,.559,16,16,1.000,3,18,21,46,1,3,14,15,92
Pat Connaughton,2021,SG,28,MIL,23,1,546,55,119,.462,37,95,.389,18,24,.750,.618,11,13,.846,29,72,101,20,10,6,12,38,158
DeMarcus Cousins,2021,C,30,LAC,7,0,58,19,42,.452,4,10,.400,15,32,.469,.500,11,14,.786,6,8,14,5,2,3,5,13,53
Robert Covington,2021,PF,30,POR,6,6,228,18,36,.500,11,22,.500,7,14,.500,.653,9,10,.900,9,38,47,7,9,6,8,20,56
Torrey Craig,2021,SF,30,PHO,22,0,266,32,75,.427,15,37,.405,17,38,.447,.527,8,13,.615,19,44,63,9,1,8,10,33,87
Jae Crowder,2021,PF,30,PHO,22,22,729,76,184,.413,54,142,.380,22,42,.524,.560,31,35,.886,10,124,134,41,19,18,19,67,237
Seth Curry,2021,SG,30,PHI,12,12,381,85,147,.578,41,81,.506,44,66,.667,.718,15,19,.789,4,24,28,28,9,3,10,33,226
Anthony Davis,2021,PF,27,LAL,5,5,144,25,62,.403,2,11,.182,23,51,.451,.419,35,42,.833,7,26,33,13,3,8,6,9,87
Dewayne Dedmon,2021,C,31,MIA,4,0,57,10,18,.556,1,3,.333,9,15,.600,.583,4,5,.800,8,10,18,3,0,2,6,10,25
Mamadi Diakite,2021,PF,24,MIL,7,0,35,2,10,.200,1,2,.500,1,8,.125,.250,2,2,1.000,1,6,7,0,3,1,1,7,7
Donte DiVincenzo,2021,SG,24,MIL,3,3,70,3,16,.188,2,12,.167,1,4,.250,.250,0,0,,2,17,19,8,3,1,6,4,8
Luka DonÄiÄ,2021,PG,21,DAL,7,7,281,96,196,.490,31,76,.408,65,120,.542,.569,27,51,.529,4,51,55,72,9,3,32,17,250
Goran DragiÄ,2021,PG,34,MIA,4,2,117,23,54,.426,9,26,.346,14,28,.500,.509,9,12,.750,1,6,7,11,4,2,6,11,64
Andre Drummond,2021,C,27,LAL,5,5,105,19,32,.594,0,0,,19,32,.594,.594,7,10,.700,19,36,55,0,4,3,11,12,45
Jared Dudley,2021,PF,35,LAL,2,0,5,0,0,,0,0,,0,0,,,0,0,,0,0,0,0,0,0,0,0,0
Kris Dunn,2021,PG,26,ATL,5,0,33,1,5,.200,0,1,.000,1,4,.250,.200,4,4,1.000,0,5,5,5,2,2,4,5,6
Kevin Durant,2021,PF,32,BRK,12,12,485,145,282,.514,33,82,.402,112,200,.560,.573,88,101,.871,5,106,111,53,18,19,42,31,411
Carsen Edwards,2021,SG,22,BOS,2,0,5,2,3,.667,1,2,.500,1,1,1.000,.833,0,0,,0,1,1,0,0,0,0,0,5
CJ Elleby,2021,SF,20,POR,2,0,8,0,1,.000,0,0,,0,1,.000,.000,0,0,,1,2,3,1,0,0,1,0,0
Joel Embiid,2021,C,26,PHI,11,11,357,101,197,.513,16,41,.390,85,156,.545,.553,91,109,.835,16,100,116,37,11,16,42,33,309
Tacko Fall,2021,C,25,BOS,1,0,1,0,0,,0,0,,0,0,,,0,0,,0,1,1,0,0,0,0,0,0
Derrick Favors,2021,C,29,UTA,11,0,145,16,23,.696,0,0,,16,23,.696,.696,5,9,.556,19,27,46,3,2,10,6,25,37
Bruno Fernando,2021,C,22,ATL,6,0,12,2,3,.667,0,0,,2,3,.667,.667,2,2,1.000,1,0,1,0,0,0,0,0,6
Yogi Ferrell,2021,PG,27,LAC,9,0,15,2,5,.400,0,1,.000,2,4,.500,.400,0,0,,0,3,3,3,0,0,0,0,4
Dorian Finney-Smith,2021,PF,27,DAL,7,7,271,26,64,.406,16,37,.432,10,27,.370,.531,4,5,.800,17,29,46,15,8,2,12,23,72
Bryn Forbes,2021,SG,27,MIL,20,0,273,46,112,.411,33,89,.371,13,23,.565,.558,6,8,.750,2,26,28,6,2,2,7,16,131
Trent Forrest,2021,PG,22,UTA,4,0,10,2,4,.500,0,0,,2,4,.500,.500,0,0,,0,0,0,0,0,0,0,0,4
Evan Fournier,2021,SG,28,BOS,5,5,167,27,63,.429,13,30,.433,14,33,.424,.532,10,12,.833,5,13,18,7,6,0,5,20,77
Enes Freedom,2021,C,28,POR,5,0,56,4,8,.500,0,0,,4,8,.500,.500,2,2,1.000,6,7,13,0,0,2,3,9,10
Daniel Gafford,2021,C,22,WAS,5,2,117,22,26,.846,0,0,,22,26,.846,.846,15,24,.625,14,15,29,3,5,10,3,17,59
Danilo Gallinari,2021,PF,32,ATL,18,0,442,74,174,.425,34,84,.405,40,90,.444,.523,49,52,.942,8,62,70,14,6,3,15,46,231
Langston Galloway,2021,SG,29,PHO,2,0,15,1,7,.143,0,2,.000,1,5,.200,.143,0,1,.000,0,2,2,1,0,1,0,1,2
Marc Gasol,2021,C,36,LAL,5,1,87,8,13,.615,7,11,.636,1,2,.500,.885,3,4,.750,4,15,19,15,4,4,4,16,26
Paul George,2021,SF,30,LAC,19,19,776,165,374,.441,51,152,.336,114,222,.514,.509,130,154,.844,17,166,183,102,19,10,67,59,511
Taj Gibson,2021,C,35,NYK,5,3,138,12,20,.600,0,0,,12,20,.600,.600,1,1,1.000,16,19,35,4,8,5,3,13,25
Harry Giles,2021,C,22,POR,1,0,4,0,1,.000,0,0,,0,1,.000,.000,0,0,,2,1,3,0,0,0,3,0,0
Anthony Gill,2021,PF,28,WAS,4,0,33,0,3,.000,0,1,.000,0,2,.000,.000,0,0,,1,3,4,0,0,0,3,7,0
Rudy Gobert,2021,C,28,UTA,11,11,376,60,81,.741,0,1,.000,60,80,.750,.741,42,66,.636,43,92,135,9,6,23,17,46,162
Aaron Gordon,2021,PF,25,DEN,10,10,299,43,99,.434,9,23,.391,34,76,.447,.480,16,25,.640,21,33,54,20,5,3,14,23,111
Danny Green,2021,SF,33,PHI,8,8,199,21,48,.438,14,37,.378,7,11,.636,.583,0,0,,9,12,21,21,9,8,5,13,56
JaMychal Green,2021,PF,30,DEN,10,0,190,20,45,.444,6,20,.300,14,25,.560,.511,8,9,.889,17,35,52,11,2,2,3,12,54
Jeff Green,2021,PF,34,BRK,6,1,148,16,33,.485,10,18,.556,6,15,.400,.636,7,8,.875,4,13,17,10,3,2,3,14,49
Josh Green,2021,SG,20,DAL,1,0,4,0,0,,0,0,,0,0,,,0,0,,0,0,0,0,0,0,0,0,0
Blake Griffin,2021,PF,31,BRK,12,12,318,42,79,.532,14,36,.389,28,43,.651,.620,10,14,.714,15,56,71,21,10,6,5,40,108
Rui Hachimura,2021,PF,22,WAS,5,5,173,29,47,.617,9,15,.600,20,32,.625,.713,7,12,.583,5,31,36,5,2,1,5,18,74
Tim Hardaway Jr.,2021,SG,28,DAL,7,7,262,42,101,.416,23,57,.404,19,44,.432,.530,12,16,.750,5,18,23,10,3,0,6,17,119
James Harden,2021,PG,31,BRK,9,9,322,51,108,.472,24,66,.364,27,42,.643,.583,56,62,.903,7,50,57,77,15,6,26,23,182
Montrezl Harrell,2021,C,27,LAL,4,0,39,8,14,.571,0,0,,8,14,.571,.571,7,9,.778,5,5,10,0,2,0,2,3,23
Joe Harris,2021,SF,29,BRK,12,12,434,49,123,.398,33,82,.402,16,41,.390,.533,3,4,.750,5,38,43,19,4,2,9,34,134
Tobias Harris,2021,PF,28,PHI,12,12,438,105,215,.488,16,43,.372,89,172,.517,.526,35,40,.875,10,92,102,42,12,5,18,29,261
Shaquille Harrison,2021,SG,27,DEN,9,0,40,3,4,.750,1,1,1.000,2,3,.667,.875,2,3,.667,0,8,8,3,3,3,5,3,9
Tyler Herro,2021,SG,21,MIA,4,0,93,12,38,.316,6,19,.316,6,19,.316,.395,7,7,1.000,1,12,13,7,1,1,3,2,37
George Hill,2021,PG,34,PHI,12,0,205,19,43,.442,8,19,.421,11,24,.458,.535,10,13,.769,5,11,16,18,8,3,10,18,56
Solomon Hill,2021,PF,29,ATL,14,3,145,6,24,.250,3,18,.167,3,6,.500,.313,2,4,.500,3,16,19,3,2,1,1,18,17
Jrue Holiday,2021,PG,30,MIL,23,23,912,158,389,.406,43,142,.303,115,247,.466,.461,40,56,.714,32,100,132,199,38,10,56,48,399
Rondae Hollis-Jefferson,2021,PF,26,POR,5,0,36,4,5,.800,0,0,,4,5,.800,.800,2,3,.667,3,5,8,0,1,1,0,5,10
Talen Horton-Tucker,2021,SG,20,LAL,4,0,48,11,24,.458,1,5,.200,10,19,.526,.479,3,5,.600,2,12,14,2,1,0,3,3,26
Dwight Howard,2021,C,35,PHI,12,0,149,16,30,.533,0,1,.000,16,29,.552,.533,24,40,.600,26,49,75,8,2,6,12,31,56
Markus Howard,2021,SG,21,DEN,9,0,112,15,37,.405,11,26,.423,4,11,.364,.554,1,2,.500,1,6,7,4,0,1,0,10,42
Kevin Huerter,2021,SG,22,ATL,18,10,558,77,180,.428,33,95,.347,44,85,.518,.519,12,17,.706,11,58,69,51,14,16,19,49,199
De'Andre Hunter,2021,SF,23,ATL,5,5,152,18,45,.400,6,16,.375,12,29,.414,.467,12,16,.750,2,18,20,3,1,3,7,11,54
Chandler Hutchison,2021,SF,24,WAS,2,0,18,2,5,.400,0,0,,2,5,.400,.400,2,2,1.000,0,3,3,1,0,0,1,1,6
Serge Ibaka,2021,C,31,LAC,2,0,18,3,6,.500,0,2,.000,3,4,.750,.500,4,4,1.000,1,3,4,2,1,3,1,1,10
Andre Iguodala,2021,SF,37,MIA,4,0,71,6,11,.545,3,7,.429,3,4,.750,.682,0,0,,3,9,12,5,4,2,5,8,15
Ersan Ä°lyasova,2021,PF,33,UTA,1,0,3,1,2,.500,0,1,.000,1,1,1.000,.500,2,2,1.000,0,0,0,0,0,0,0,0,4
Joe Ingles,2021,SF,33,UTA,11,6,306,39,79,.494,24,58,.414,15,21,.714,.646,10,13,.769,1,33,34,38,7,0,9,19,112
Kyrie Irving,2021,PG,28,BRK,9,9,325,77,163,.472,24,65,.369,53,98,.541,.546,26,28,.929,12,40,52,31,9,5,11,19,204
Jaren Jackson Jr.,2021,C,21,MEM,5,5,137,23,54,.426,8,28,.286,15,26,.577,.500,14,16,.875,9,19,28,5,5,6,4,21,68
Justin Jackson,2021,SF,25,MIL,5,0,15,3,5,.600,0,2,.000,3,3,1.000,.600,0,0,,1,1,2,1,1,0,1,0,6
Reggie Jackson,2021,SG,30,LAC,19,17,622,122,252,.484,58,142,.408,64,110,.582,.599,36,41,.878,7,53,60,65,18,3,28,49,338
LeBron James,2021,PG,36,LAL,6,6,224,54,114,.474,18,48,.375,36,66,.545,.553,14,23,.609,7,36,43,48,9,2,25,7,140
Mike James,2021,PG,30,BRK,9,0,103,14,43,.326,5,16,.313,9,27,.333,.384,0,0,,2,14,16,12,2,0,3,6,33
Isaiah Joe,2021,SG,21,PHI,4,0,9,1,3,.333,0,2,.000,1,1,1.000,.333,0,0,,0,0,0,1,0,0,0,2,2
Alize Johnson,2021,PF,24,BRK,5,0,23,4,7,.571,0,0,,4,7,.571,.571,0,0,,3,10,13,0,3,0,3,1,8
Cameron Johnson,2021,PF,24,PHO,21,0,443,55,110,.500,33,74,.446,22,36,.611,.650,29,32,.906,16,50,66,16,19,4,15,28,172
Tyler Johnson,2021,SG,28,BRK,8,0,69,6,17,.353,3,11,.273,3,6,.500,.441,2,2,1.000,2,4,6,5,2,0,1,9,17
Nikola JokiÄ,2021,C,25,DEN,10,10,345,116,228,.509,20,53,.377,96,175,.549,.553,46,55,.836,37,79,116,50,6,9,24,23,298
Derrick Jones Jr.,2021,SF,23,POR,2,0,10,2,5,.400,0,2,.000,2,3,.667,.400,0,0,,0,0,0,0,1,0,0,2,4
Tyus Jones,2021,PG,24,MEM,5,0,47,6,17,.353,1,4,.250,5,13,.385,.382,2,2,1.000,1,6,7,6,1,0,0,1,15
Frank Kaminsky,2021,C,27,PHO,10,0,68,10,22,.455,1,5,.200,9,17,.529,.477,1,1,1.000,2,12,14,14,2,3,4,9,22
Luke Kennard,2021,SG,24,LAC,15,0,219,31,65,.477,21,51,.412,10,14,.714,.638,1,2,.500,5,9,14,7,2,0,3,15,84
Maxi Kleber,2021,PF,29,DAL,7,4,187,12,30,.400,8,20,.400,4,10,.400,.533,5,7,.714,5,20,25,10,3,0,1,19,37
Nathan Knight,2021,PF,23,ATL,6,0,14,2,7,.286,0,2,.000,2,5,.400,.286,0,2,.000,0,6,6,0,0,2,0,2,4
Kevin Knox,2021,SF,21,NYK,1,0,4,0,0,,0,0,,0,0,,,2,2,1.000,0,1,1,1,0,1,0,0,2
John Konchar,2021,SG,24,MEM,1,0,3,0,1,.000,0,1,.000,0,0,,.000,0,0,,0,1,1,0,0,1,0,0,0
Furkan Korkmaz,2021,SG,23,PHI,12,4,195,30,73,.411,14,44,.318,16,29,.552,.507,10,14,.714,4,20,24,7,7,3,5,9,84
Luke Kornet,2021,C,25,BOS,2,0,5,1,1,1.000,0,0,,1,1,1.000,1.000,1,2,.500,0,3,3,0,0,0,0,0,3
Kyle Kuzma,2021,SF,25,LAL,6,0,129,14,48,.292,4,23,.174,10,25,.400,.333,6,9,.667,4,19,23,7,2,1,6,8,38
Romeo Langford,2021,SG,21,BOS,4,2,109,13,32,.406,6,17,.353,7,15,.467,.500,4,4,1.000,5,5,10,5,3,2,1,2,36
T.J. Leaf,2021,PF,23,POR,3,0,7,3,4,.750,0,0,,3,4,.750,.750,0,0,,2,1,3,0,0,0,0,0,6
Alex Len,2021,C,27,WAS,5,3,42,8,14,.571,0,0,,8,14,.571,.571,4,7,.571,4,7,11,2,1,0,1,8,20
Kawhi Leonard,2021,SF,29,LAC,11,11,432,122,213,.573,24,61,.393,98,152,.645,.629,66,75,.880,22,63,85,48,23,9,24,29,334
Damian Lillard,2021,PG,30,POR,6,6,248,62,134,.463,35,78,.449,27,56,.482,.593,47,50,.940,1,25,26,61,6,4,13,9,206
Nassir Little,2021,PF,20,POR,3,0,9,1,4,.250,1,4,.250,0,0,,.375,2,4,.500,0,1,1,0,0,1,1,0,5
Brook Lopez,2021,C,32,MIL,23,23,667,119,217,.548,23,72,.319,96,145,.662,.601,37,43,.860,48,87,135,6,17,34,25,48,298
Robin Lopez,2021,C,32,WAS,5,0,73,18,25,.720,0,0,,18,25,.720,.720,1,4,.250,4,5,9,0,0,4,1,7,37
TimothÃ© Luwawu-Cabarrot,2021,SF,25,BRK,7,0,25,3,10,.300,2,6,.333,1,4,.250,.400,0,0,,0,3,3,2,0,0,1,1,8
Terance Mann,2021,SG,24,LAC,19,6,378,54,104,.519,16,37,.432,38,67,.567,.596,20,28,.714,17,35,52,14,10,5,4,41,144
Boban MarjanoviÄ,2021,C,32,DAL,4,3,83,20,39,.513,0,0,,20,39,.513,.513,7,9,.778,14,18,32,4,0,1,4,13,47
Garrison Mathews,2021,SG,24,WAS,3,0,17,0,4,.000,0,4,.000,0,0,,.000,4,5,.800,0,2,2,0,0,0,0,4,4
Wesley Matthews,2021,SG,34,LAL,6,1,110,10,33,.303,7,25,.280,3,8,.375,.409,6,6,1.000,5,5,10,2,2,0,0,13,33
Tyrese Maxey,2021,SG,20,PHI,12,0,156,29,66,.439,4,12,.333,25,54,.463,.470,14,22,.636,1,21,22,16,3,6,5,16,76
Skylar Mays,2021,SG,23,ATL,7,0,17,4,5,.800,0,0,,4,5,.800,.800,0,0,,0,2,2,1,2,0,1,1,8
CJ McCollum,2021,SG,29,POR,6,6,240,50,114,.439,14,42,.333,36,72,.500,.500,10,13,.769,6,30,36,26,2,4,12,25,124
JaVale McGee,2021,C,33,DEN,4,0,34,3,10,.300,0,2,.000,3,8,.375,.300,2,6,.333,3,9,12,3,1,5,1,4,8
Alfonzo McKinnie,2021,SF,28,LAL,2,0,12,0,3,.000,0,2,.000,0,1,.000,.000,0,0,,0,1,1,0,0,0,0,1,0
Ben McLemore,2021,SG,27,LAL,4,0,36,2,9,.222,2,6,.333,0,3,.000,.333,0,0,,1,6,7,1,1,0,1,5,6
NicolÃ² Melli,2021,PF,30,DAL,3,0,19,0,4,.000,0,2,.000,0,2,.000,.000,0,0,,2,4,6,0,1,0,0,3,0
De'Anthony Melton,2021,PG,22,MEM,5,0,83,11,31,.355,6,20,.300,5,11,.455,.452,3,5,.600,4,12,16,5,1,4,3,7,31
Sam Merrill,2021,SG,24,MIL,8,0,30,2,7,.286,1,5,.200,1,2,.500,.357,0,0,,1,4,5,1,4,0,1,2,5
Khris Middleton,2021,SF,29,MIL,23,23,922,198,452,.438,60,175,.343,138,277,.498,.504,86,97,.887,25,149,174,118,35,4,74,58,542
Paul Millsap,2021,PF,35,DEN,9,0,109,22,50,.440,6,23,.261,16,27,.593,.500,8,13,.615,9,26,35,15,3,6,8,14,58
Shake Milton,2021,SG,24,PHI,12,0,121,15,47,.319,8,19,.421,7,28,.250,.404,14,15,.933,0,9,9,9,3,1,11,18,52
Donovan Mitchell,2021,PG,24,UTA,10,10,346,105,235,.447,50,115,.435,55,120,.458,.553,63,76,.829,3,39,42,55,11,2,28,20,323
E'Twaun Moore,2021,SG,31,PHO,7,0,46,8,18,.444,1,5,.200,7,13,.538,.472,0,0,,0,10,10,9,1,0,3,3,17
Ja Morant,2021,PG,21,MEM,5,5,203,55,113,.487,10,31,.323,45,82,.549,.531,31,40,.775,7,17,24,41,2,0,17,9,151
Juwan Morgan,2021,PF,23,UTA,2,0,6,0,0,,0,0,,0,0,,,0,0,,1,1,2,1,0,0,0,1,0
Marcus Morris,2021,PF,31,LAC,19,18,604,86,200,.430,36,96,.375,50,104,.481,.520,24,32,.750,13,68,81,28,10,10,7,49,232
Markieff Morris,2021,PF,31,LAL,4,1,38,2,9,.222,1,4,.250,1,5,.200,.278,4,6,.667,4,0,4,3,0,1,2,6,9
Monte Morris,2021,PG,25,DEN,10,1,286,50,116,.431,16,40,.400,34,76,.447,.500,21,29,.724,7,17,24,55,10,2,7,12,137
Abdel Nader,2021,SF,27,PHO,5,0,29,2,6,.333,0,2,.000,2,4,.500,.333,0,0,,0,5,5,0,0,0,0,3,4
Aaron Nesmith,2021,SF,21,BOS,5,0,75,5,18,.278,4,14,.286,1,4,.250,.389,2,2,1.000,2,11,13,1,1,1,2,7,16
Raul Neto,2021,PG,28,WAS,5,3,112,12,34,.353,4,15,.267,8,19,.421,.412,4,5,.800,3,8,11,5,2,0,1,11,32
Georges Niang,2021,PF,27,UTA,11,0,129,11,39,.282,9,30,.300,2,9,.222,.397,4,4,1.000,2,17,19,8,0,1,8,19,35
Zeke Nnaji,2021,PF,20,DEN,5,0,18,4,8,.500,3,7,.429,1,1,1.000,.688,1,2,.500,1,1,2,2,1,0,0,1,12
Nerlens Noel,2021,C,26,NYK,5,2,92,5,10,.500,0,0,,5,10,.500,.500,13,16,.813,10,10,20,1,4,3,4,15,23
Frank Ntilikina,2021,PG,22,NYK,3,0,4,0,1,.000,0,1,.000,0,0,,.000,0,0,,0,0,0,0,0,0,0,0,0
Kendrick Nunn,2021,PG,25,MIA,4,2,93,17,43,.395,5,18,.278,12,25,.480,.453,2,2,1.000,0,6,6,6,2,0,3,4,41
Jusuf NurkiÄ,2021,C,26,POR,6,6,173,30,55,.545,1,5,.200,29,50,.580,.555,18,25,.720,18,44,62,16,3,7,14,30,79
Jordan Nwora,2021,SF,22,MIL,5,0,31,4,18,.222,2,8,.250,2,10,.200,.278,5,7,.714,5,4,9,1,0,1,1,1,15
Royce O'Neale,2021,SF,27,UTA,11,11,404,43,85,.506,28,60,.467,15,25,.600,.671,10,12,.833,16,64,80,23,12,3,8,41,124
Semi Ojeleye,2021,PF,26,BOS,2,0,12,0,4,.000,0,3,.000,0,1,.000,.000,1,2,.500,0,0,0,0,1,1,0,0,1
Onyeka Okongwu,2021,C,20,ATL,18,0,166,17,31,.548,0,1,.000,17,30,.567,.548,14,21,.667,21,27,48,2,5,13,4,28,48
KZ Okpala,2021,PF,21,MIA,2,0,6,0,1,.000,0,1,.000,0,0,,.000,0,0,,0,0,0,0,0,0,0,0,0
Miye Oni,2021,SG,23,UTA,8,0,41,0,5,.000,0,5,.000,0,0,,.000,0,0,,3,0,3,0,1,0,0,8,0
Daniel Oturu,2021,C,21,LAC,8,0,15,2,5,.400,0,1,.000,2,4,.500,.400,1,2,.500,2,2,4,0,0,1,0,2,5
Jabari Parker,2021,PF,25,BOS,4,0,59,13,21,.619,2,5,.400,11,16,.688,.667,6,8,.750,2,13,15,2,0,3,6,7,34
Chris Paul,2021,PG,35,PHO,20,20,683,149,300,.497,29,65,.446,120,235,.511,.545,57,65,.877,9,61,70,171,23,3,43,48,384
Cameron Payne,2021,PG,26,PHO,22,2,418,82,193,.425,25,69,.362,57,124,.460,.490,16,18,.889,6,49,55,70,17,11,24,39,205
Elfrid Payton,2021,PG,26,NYK,2,2,13,0,5,.000,0,0,,0,5,.000,.000,1,2,.500,0,0,0,1,1,0,0,1,1
Reggie Perry,2021,PF,20,BRK,5,0,22,7,13,.538,2,5,.400,5,8,.625,.615,0,0,,4,2,6,1,1,0,3,4,16
Michael Porter Jr.,2021,SF,22,DEN,10,10,332,64,135,.474,29,73,.397,35,62,.565,.581,17,21,.810,12,50,62,13,11,3,16,31,174
Bobby Portis,2021,C,25,MIL,20,2,366,70,151,.464,18,52,.346,52,99,.525,.523,18,25,.720,33,67,100,12,14,7,9,31,176
Kristaps PorziÅÄ£is,2021,C,25,DAL,7,7,233,34,72,.472,8,27,.296,26,45,.578,.528,16,19,.842,7,31,38,9,9,5,3,19,92
Dwight Powell,2021,C,29,DAL,7,0,52,7,8,.875,0,0,,7,8,.875,.875,5,6,.833,5,8,13,6,2,0,1,8,19
Norman Powell,2021,SF,27,POR,6,6,216,38,76,.500,10,26,.385,28,50,.560,.566,16,18,.889,3,10,13,12,5,6,7,17,102
Payton Pritchard,2021,SG,23,BOS,5,0,67,6,17,.353,3,10,.300,3,7,.429,.441,2,2,1.000,2,7,9,12,2,0,3,4,17
Immanuel Quickley,2021,PG,21,NYK,5,0,77,10,33,.303,4,11,.364,6,22,.273,.364,5,7,.714,0,7,7,5,3,0,6,8,29
Julius Randle,2021,PF,26,NYK,5,5,180,28,94,.298,11,33,.333,17,61,.279,.356,23,27,.852,11,47,58,20,3,0,23,18,90
Cam Reddish,2021,SF,21,ATL,4,0,92,19,36,.528,9,14,.643,10,22,.455,.653,4,5,.800,1,13,14,7,6,2,5,11,51
Paul Reed,2021,PF,21,PHI,3,0,11,2,4,.500,0,0,,2,4,.500,.500,0,0,,3,5,8,0,0,1,0,1,4
Josh Richardson,2021,SG,27,DAL,7,0,94,11,28,.393,3,10,.300,8,18,.444,.446,9,9,1.000,3,8,11,5,2,0,6,8,34
Austin Rivers,2021,SG,28,DEN,10,9,305,30,69,.435,19,46,.413,11,23,.478,.572,13,16,.813,1,16,17,21,2,3,9,32,92
Duncan Robinson,2021,SF,26,MIA,4,4,100,11,29,.379,10,27,.370,1,2,.500,.552,9,10,.900,0,11,11,3,3,0,4,13,41
Rajon Rondo,2021,PG,34,LAC,13,0,220,18,53,.340,11,28,.393,7,25,.280,.443,8,12,.667,4,30,34,50,5,3,14,18,55
Derrick Rose,2021,PG,32,NYK,5,3,175,40,84,.476,8,17,.471,32,67,.478,.524,9,9,1.000,4,16,20,25,2,1,8,5,97
Dario Å ariÄ,2021,C,26,PHO,14,0,147,21,45,.467,8,18,.444,13,27,.481,.556,13,14,.929,9,26,35,14,2,1,6,21,63
Dennis SchrÃ¶der,2021,SG,27,LAL,6,6,196,28,70,.400,8,26,.308,20,44,.455,.457,22,26,.846,1,17,18,17,6,1,10,13,86
Mike Scott,2021,PF,32,PHI,5,0,34,2,9,.222,2,7,.286,0,2,.000,.333,0,0,,1,2,3,3,1,1,0,3,6
Jay Scrubb,2021,SG,20,LAC,6,0,8,0,0,,0,0,,0,0,,,0,0,,0,1,1,0,0,0,0,0,0
Landry Shamet,2021,SG,23,BRK,12,0,206,18,41,.439,10,26,.385,8,15,.533,.561,4,5,.800,3,18,21,7,5,1,6,19,50
Ben Simmons,2021,PG,24,PHI,12,12,402,59,95,.621,0,1,.000,59,94,.628,.621,25,73,.342,25,70,95,106,15,10,27,39,143
Anfernee Simons,2021,SG,21,POR,6,0,107,14,25,.560,11,18,.611,3,7,.429,.780,0,0,,3,13,16,5,2,1,1,6,39
Marcus Smart,2021,PG,26,BOS,5,5,183,29,66,.439,16,43,.372,13,23,.565,.561,15,21,.714,4,18,22,30,5,1,14,14,89
Ish Smith,2021,PG,32,WAS,5,0,111,16,43,.372,2,7,.286,14,36,.389,.395,0,0,,1,15,16,14,7,2,5,11,34
Jalen Smith,2021,PF,20,PHO,6,0,18,2,4,.500,1,1,1.000,1,3,.333,.625,0,0,,2,3,5,1,0,0,1,2,5
Tony Snell,2021,SG,29,ATL,9,0,66,2,16,.125,1,11,.091,1,5,.200,.156,0,0,,0,5,5,2,2,1,4,5,5
Max Strus,2021,SF,24,MIA,2,0,6,0,1,.000,0,0,,0,1,.000,.000,0,0,,0,0,0,0,0,0,0,0,0
Jayson Tatum,2021,SF,22,BOS,5,5,185,47,111,.423,14,36,.389,33,75,.440,.486,45,49,.918,3,26,29,23,6,8,13,15,153
Jeff Teague,2021,PG,32,MIL,16,0,119,9,31,.290,5,11,.455,4,20,.200,.371,9,11,.818,2,6,8,13,3,0,6,9,32
Matt Thomas,2021,SG,26,UTA,3,0,7,0,2,.000,0,0,,0,2,.000,.000,0,0,,0,1,1,0,0,0,0,1,0
Tristan Thompson,2021,PF,29,BOS,5,5,132,20,34,.588,0,0,,20,34,.588,.588,12,17,.706,29,20,49,5,4,6,5,12,52
Matisse Thybulle,2021,SG,23,PHI,12,1,220,25,52,.481,11,34,.324,14,18,.778,.587,2,5,.400,4,13,17,3,16,11,2,29,63
Xavier Tillman Sr.,2021,PF,22,MEM,3,0,18,1,5,.200,0,1,.000,1,4,.250,.200,0,0,,1,2,3,1,1,0,1,2,2
Anthony Tolliver,2021,PF,35,PHI,1,0,2,0,0,,0,0,,0,0,,,0,0,,0,0,0,0,0,0,0,1,0
Obi Toppin,2021,PF,22,NYK,5,0,65,12,23,.522,3,9,.333,9,14,.643,.587,5,6,.833,4,9,13,2,0,1,3,6,32
Axel Toupane,2021,SF,28,MIL,4,0,10,2,4,.500,1,2,.500,1,2,.500,.625,0,0,,2,2,4,0,0,0,0,0,5
P.J. Tucker,2021,PF,35,MIL,23,19,681,38,98,.388,19,59,.322,19,39,.487,.485,3,4,.750,48,63,111,25,22,3,10,77,98
Rayjon Tucker,2021,PG,23,PHI,1,0,2,0,0,,0,0,,0,0,,,1,2,.500,0,0,0,0,0,0,0,1,1
Jonas ValanÄiÅ«nas,2021,C,28,MEM,5,5,166,33,58,.569,2,8,.250,31,50,.620,.586,7,8,.875,20,29,49,13,3,3,10,18,75
Gabe Vincent,2021,PG,24,MIA,3,0,14,2,3,.667,1,2,.500,1,1,1.000,.833,0,0,,0,1,1,2,0,0,1,0,5
Kemba Walker,2021,PG,30,BOS,3,3,91,13,41,.317,3,17,.176,10,24,.417,.354,9,10,.900,0,12,12,12,1,0,8,10,38
Tremont Waters,2021,PG,23,BOS,3,0,6,1,4,.250,0,2,.000,1,2,.500,.250,2,3,.667,0,0,0,2,1,0,2,0,4
Russell Westbrook,2021,PG,32,WAS,5,5,186,28,84,.333,5,20,.250,23,64,.359,.363,34,43,.791,14,38,52,59,2,1,21,17,95
Grant Williams,2021,PF,22,BOS,5,0,57,6,12,.500,2,4,.500,4,8,.500,.583,3,3,1.000,3,7,10,4,1,4,1,7,17
Lou Williams,2021,PG,34,ATL,18,2,277,50,110,.455,13,30,.433,37,80,.463,.514,26,27,.963,2,24,26,39,12,1,22,16,139
Robert Williams,2021,C,23,BOS,3,0,46,9,14,.643,0,0,,9,14,.643,.643,1,2,.500,8,7,15,2,1,9,1,7,19
Justise Winslow,2021,SF,24,MEM,1,0,3,0,0,,0,0,,0,0,,,0,0,,0,1,1,1,0,0,0,0,0
Cassius Winston,2021,PG,22,WAS,1,0,5,1,3,.333,0,1,.000,1,2,.500,.333,0,0,,1,1,2,1,0,0,2,1,2
Trae Young,2021,PG,22,ATL,16,16,603,150,359,.418,45,144,.313,105,215,.488,.481,116,134,.866,7,38,45,152,20,0,64,35,461
Ivica Zubac,2021,C,23,LAC,17,7,301,34,57,.596,0,0,,34,57,.596,.596,39,49,.796,43,56,99,7,2,12,16,33,107
